KISS1R	性早熟	PRECOCIOUS PUBERTY, CENTRAL, 1
MNX1	Currarino三联症	CURRARINO SYNDROME
ITM2B	脑淀粉样血管病	CEREBRAL AMYLOID ANGIOPATHY, ITM2B-RELATED, 1
LMNA	早老症	HUTCHINSON-GILFORD PROGERIA SYNDROME
COMP	软骨发育不全	PSEUDOACHONDROPLASIA
GP1BA	血管性血友病	PSEUDO-VON WILLEBRAND DISEASE
ABCC6	弹性假黄瘤	PSEUDOXANTHOMA ELASTICUM, FORME FRUSTE
SFTPA2	特发性肺纤维化	PULMONARY FIBROSIS, IDIOPATHIC
ACVRL1	肺动脉高压	PULMONARY HYPERTENSION, PRIMARY, 1
KRT5	道[林]-德[戈斯]二氏病	DOWLING-DEGOS DISEASE 1
RP9	视网膜色素变性	RETINITIS PIGMENTOSA 9
IMPDH1	视网膜色素变性	RETINITIS PIGMENTOSA 10
PITX2	阿克森费尔德-里格尔综合征	AXENFELD-RIEGER SYNDROME, TYPE 1
PITX2	角膜环状皮样瘤	RING DERMOID OF CORNEA
TWIST1	ROBINOW-SORAUF综合征	ROBINOW-SORAUF SYNDROME
CREBBP	Rubinstein-Taybi综合征	RUBINSTEIN-TAYBI SYNDROME 1
FGF10	泪腺和唾液腺发育不良	APLASIA OF LACRIMAL AND SALIVARY GLANDS
DES	肩胛腓骨萎缩症	SCAPULOPERONEAL SYNDROME, NEUROGENIC, KAESER TYPE
TRPV4	肩胛腓骨萎缩症	SCAPULOPERONEAL SPINAL MUSCULAR ATROPHY
MYH7	MYH7相关的肩胛腓骨肌病	SCAPULOPERONEAL MYOPATHY, MYH7-RELATED
TBX3	尺骨-乳房综合征	ULNAR-MAMMARY SYNDROME
FGFR3	脂溢性角化病	KERATOSIS, SEBORRHEIC
FBN1	斯普林泽颅缝早闭综合征（软腭-心-面综合征）	SHPRINTZEN-GOLDBERG CRANIOSYNOSTOSIS SYNDROME
HESX1	透明中隔一视神经发育不良综合征	SEPTOOPTIC DYSPLASIA
RAI1	Smith-Magenis综合征	SMITH-MAGENIS SYNDROME
ATL1	遗传性痉挛性截瘫	SPASTIC PARAPLEGIA 3, AUTOSOMAL DOMINANT
SPAST	遗传性痉挛性截瘫	SPASTIC PARAPLEGIA 4, AUTOSOMAL DOMINANT
MYOT	球状体肌病	MYOPATHY, SPHEROID BODY
VANGL1	神经管缺陷	NEURAL TUBE DEFECTS, SUSCEPTIBILITY TO
VAPB	脊髓性肌萎缩症	SPINAL MUSCULAR ATROPHY, LATE-ONSET, FINKEL TYPE
CACNA1A	脊髓小脑性共济失调	SPINOCEREBELLAR ATAXIA 6
TRPV4	脊椎骨骺发育不良	SPONDYLOEPIPHYSEAL DYSPLASIA, MAROTEAUX TYPE
TRPV4	脊椎干骺端发育不良	SPONDYLOMETAPHYSEAL DYSPLASIA, KOZLOWSKI TYPE
NOG	镫骨关节强硬无关节融合	STAPES ANKYLOSIS WITH BROAD THUMB AND TOES
KRT17	多发性皮脂腺囊肿	STEATOCYSTOMA MULTIPLEX
ELN	主动脉瓣上狭窄	SUPRAVALVULAR AORTIC STENOSIS
NOG	近端指(趾)间关节粘连	SYMPHALANGISM, PROXIMAL, 1A
GDF5	近端指(趾)间关节粘连	SYMPHALANGISM, PROXIMAL, 1A
HOXD13	并指(趾)多指(趾)	SYNPOLYDACTYLY 1
GJA1	并指	SYNDACTYLY, TYPE III
HOXD13	并指	SYNDACTYLY, TYPE V
NOG	多发性骨性连接综合征	MULTIPLE SYNOSTOSES SYNDROME 1
NOG	跗骨腕骨合并综合征	TARSAL-CARPAL COALITION SYNDROME
NOD2	布劳综合征	BLAU SYNDROME
ENG	遗传性出血性毛细血管扩张症	TELANGIECTASIA, HEREDITARY HEMORRHAGIC, OF RENDU, OSLER, AND WEBER
JAG1	法洛四联症	TETRALOGY OF FALLOT
NKX2-5	法洛四联症	TETRALOGY OF FALLOT
ZFPM2	法洛四联症	TETRALOGY OF FALLOT
GDF1	法洛四联症	TETRALOGY OF FALLOT
GATA4	法洛四联症	TETRALOGY OF FALLOT
FGFR3	致死性颅骨发育不良	THANATOPHORIC DYSPLASIA, TYPE I
MASTL	血小板减少症	THROMBOCYTOPENIA 2
F5	血栓	THROMBOPHILIA DUE TO ACTIVATED PROTEIN C RESISTANCE
TBX1	DiGeorge综合征	DIGEORGE SYNDROME
THRB	甲状腺激素抵抗综合征	THYROID HORMONE RESISTANCE, GENERALIZED, AUTOSOMAL DOMINANT
MSX1	Witkop综合征	WITKOP SYNDROME
TRPS1	毛发-鼻-指(趾)综合征	TRICHORHINOPHALANGEAL SYNDROME, TYPE I
TRPS1	毛发-鼻-指(趾)综合征	TRICHORHINOPHALANGEAL SYNDROME, TYPE III
FGFR1	三角头(畸形)	TRIGONOCEPHALY 1
OPN1SW	部分色盲	TRITANOPIA
RET	肾发育不良	RENAL HYPODYSPLASIA/APLASIA 1
UPK3A	肾发育不良	RENAL HYPODYSPLASIA/APLASIA 1
NLRP3	穆-韦二氏综合征(粉样变性-耳聋-荨麻疹-肢痛综合征)	MUCKLE-WELLS SYNDROME
TBX1	腭-心-面综合征	VELOCARDIOFACIAL SYNDROME
KCNQ1	长Q-T间期综合征	LONG QT SYNDROME 1
MYH7	家族性肥厚型心肌病	CARDIOMYOPATHY, FAMILIAL HYPERTROPHIC, 1
HOXD10	先天性垂直距骨	VERTICAL TALUS, CONGENITAL
FGF23	低磷酸盐血症性佝偻病	HYPOPHOSPHATEMIC RICKETS, AUTOSOMAL DOMINANT
BEST1	玻璃体视网膜脉络膜病	VITREORETINOCHOROIDOPATHY
KCNJ13	视网膜变性	VITREORETINAL DEGENERATION, SNOWFLAKE TYPE
VHL	vonHippel-Lindau综合征	VON HIPPEL-LINDAU SYNDROME
VWF	血管性血友病	VON WILLEBRAND DISEASE, TYPE 1
MITF	瓦登伯革氏症候群	WAARDENBURG SYNDROME, TYPE 2A
EVC	面骨发育不全综合征	WEYERS ACROFACIAL DYSOSTOSIS
EVC2	面骨发育不全综合征	WEYERS ACROFACIAL DYSOSTOSIS
CXCR4	WHIM综合征	WHIM SYNDROME
MYH3	远端关节弯曲	ARTHROGRYPOSIS, DISTAL, TYPE 2A
KRT13	黏膜白色海绵痣	WHITE SPONGE NEVUS 1
WT1	肾母细胞瘤	WILMS TUMOR 1
WT1	Denys-Drash综合征	DENYS-DRASH SYNDROME
PRKAG2	午－帕－怀三氏综合症(预激综合征)	WOLFF-PARKINSON-WHITE SYNDROME
KRT74	羊毛状发	WOOLLY HAIR, AUTOSOMAL DOMINANT
VPS13A	舞蹈病棘红细胞增多症	CHOREOACANTHOCYTOSIS
COL2A1	软骨发育不全	ACHONDROGENESIS, TYPE II
GDF5	软骨发育不全	CHONDRODYSPLASIA, GREBE TYPE
GLI3	Acrocallosa综合征	ACROCALLOSAL SYNDROME
RAB23	尖头多指并指畸形综合征	CARPENTER SYNDROME 1
SLC39A4	肠病性肢端皮炎	ACRODERMATITIS ENTEROPATHICA, ZINC-DEFICIENCY TYPE
WNK1	感觉自主神经病	NEUROPATHY, HEREDITARY SENSORY AND AUTONOMIC, TYPE IIA
TBX19	孤立性ACTH缺乏症	ACTH DEFICIENCY, ISOLATED
ACADM	氧化还原酶缺乏症	ACYL-CoA DEHYDROGENASE, MEDIUM-CHAIN, DEFICIENCY OF
ACADS	氧化还原酶缺乏症	ACYL-CoA DEHYDROGENASE, SHORT-CHAIN, DEFICIENCY OF
ACADVL	氧化还原酶缺乏症	ACYL-CoA DEHYDROGENASE, VERY LONG-CHAIN, DEFICIENCY OF
STAR	先天性肾上腺皮质增生症	LIPOID CONGENITAL ADRENAL HYPERPLASIA
POR	颅缝早闭综合征	ANTLEY-BIXLER SYNDROME WITH GENITAL ANOMALIES AND DISORDERED STEROIDOGENESIS
CYP11B1	先天性肾上腺皮质增生症	ADRENAL HYPERPLASIA, CONGENITAL, DUE TO STEROID 11-BETA-HYDROXYLASE
CYP17A1	先天性肾上腺皮质增生症	ADRENAL HYPERPLASIA, CONGENITAL, DUE TO 17-ALPHA-HYDROXYLASE DEFICIENCY
MC2R	糖皮质激素缺乏症	GLUCOCORTICOID DEFICIENCY 1
PEX5	雷夫叙姆病	PEROXISOME BIOGENESIS DISORDER 2B
PEX1	雷夫叙姆病	PEROXISOME BIOGENESIS DISORDER 2B
PEX10	雷夫叙姆病	PEROXISOME BIOGENESIS DISORDER 2B
FGB	先天性纤维蛋白原缺乏症	AFIBRINOGENEMIA, CONGENITAL
FGG	先天性纤维蛋白原缺乏症	AFIBRINOGENEMIA, CONGENITAL
ELANE	中性粒细胞减少症	NEUTROPENIA, SEVERE CONGENITAL, 1, AUTOSOMAL DOMINANT
TYR	白化病	ALBINISM, OCULOCUTANEOUS, TYPE IA
OCA2	白化病	ALBINISM, OCULOCUTANEOUS, TYPE II
TYRP1	白化病	ALBINISM, OCULOCUTANEOUS, TYPE III
HPS3	Hermansky-Pudlak综合征	HERMANSKY-PUDLAK SYNDROME 1
CYP11B2	皮质酮甲基氧化酶I型缺乏症	CORTICOSTERONE METHYLOXIDASE TYPE I DEFICIENCY
GFAP	亚力山大病	ALEXANDER DISEASE
HGD	氧化还原酶缺乏症	ALKAPTONURIA
HR	先天性普秃	ALOPECIA UNIVERSALIS CONGENITA
POLG	线粒体DNA缺失综合征	MITOCHONDRIAL DNA DEPLETION SYNDROME 4A (ALPERS TYPE)
ACAT1	α-甲基乙酰乙酸尿症	ALPHA-METHYLACETOACETIC ACIDURIA
ALMS1	Alstrom综合征	ALSTROM SYNDROME
GUCY2D	莱伯氏先天性黑矇	LEBER CONGENITAL AMAUROSIS 1
TPP1	神经元蜡样质脂褐质沉积症	CEROID LIPOFUSCINOSIS, NEURONAL, 2
KLK4	牙釉质发育不全	AMELOGENESIS IMPERFECTA, HYPOMATURATION TYPE, IIA1
TACSTD2	角膜营养不良	CORNEAL DYSTROPHY, GELATINOUS DROP-LIKE
ALS2	肌萎缩侧索硬化	AMYOTROPHIC LATERAL SCLEROSIS 2, JUVENILE
ABCA1	丹吉尔病	TANGIER DISEASE
SLC25A38	铁粒幼细胞贫血	ANEMIA, SIDEROBLASTIC, PYRIDOXINE-REFRACTORY, AUTOSOMAL RECESSIVE
GLRX5	铁粒幼细胞贫血	ANEMIA, SIDEROBLASTIC, PYRIDOXINE-REFRACTORY, AUTOSOMAL RECESSIVE
SLC11A2	贫血	ANEMIA, HYPOCHROMIC MICROCYTIC, WITH IRON OVERLOAD 1
PAX6	先天性无虹膜	ANIRIDIA, CEREBELLAR ATAXIA, AND MENTAL RETARDATION
RSPO4	非综合征性先天性指甲障碍	NAIL DISORDER, NONSYNDROMIC CONGENITAL, 4
SOX2	小眼畸形综合征	MICROPHTHALMIA, SYNDROMIC 3
FGFR2	颅缝早闭综合征	ANTLEY-BIXLER SYNDROME WITHOUT GENITAL ANOMALIES OR DISORDERED STEROIDOGENESIS
APOC2	载脂蛋白C-II缺乏症	APOLIPOPROTEIN C-II DEFICIENCY
ARG1	水解酶缺乏症	ARGININEMIA
ASL	水解酶缺乏症	ARGININOSUCCINIC ACIDURIA
ENPP1	婴儿期特发性动脉钙化	ARTERIAL CALCIFICATION, GENERALIZED, OF INFANCY, 1
SLC2A10	动脉迂曲综合征	ARTERIAL TORTUOSITY SYNDROME
VPS33B	关节挛缩肾功能障碍与胆汁淤积	ARTHROGRYPOSIS, RENAL DYSFUNCTION, AND CHOLESTASIS 1
RAPSN	胎儿运动机能丧失变型序列	FETAL AKINESIA DEFORMATION SEQUENCE
WISP3	儿童进行性假类风湿性关节病	ARTHROPATHY, PROGRESSIVE PSEUDORHEUMATOID, OF CHILDHOOD
AGA	水解酶缺乏症	ASPARTYLGLUCOSAMINURIA
NPHP3	肾肝胰发育不良综合征	RENAL-HEPATIC-PANCREATIC DYSPLASIA 1
ATM	共济失调性毛细血管扩张症	ATAXIA-TELANGIECTASIA
APTX	早发型共济失调伴动眼不能和低白蛋白血症	ATAXIA, EARLY-ONSET, WITH OCULOMOTOR APRAXIA AND HYPOALBUMINEMIA
TF	先天性无转铁蛋白血症	ATRANSFERRINEMIA
HR	先天性无毛症伴丘疹性损害	ATRICHIA WITH PAPULAR LESIONS
RET	先天性中枢性低通气综合征	CENTRAL HYPOVENTILATION SYNDROME, CONGENITAL
GDNF	先天性中枢性低通气综合征	CENTRAL HYPOVENTILATION SYNDROME, CONGENITAL
BDNF	先天性中枢性低通气综合征	CENTRAL HYPOVENTILATION SYNDROME, CONGENITAL
ASCL1	先天性中枢性低通气综合征	CENTRAL HYPOVENTILATION SYNDROME, CONGENITAL
IFNGR1	免疫缺陷	IMMUNODEFICIENCY 27A
IFNGR2	免疫缺陷	IMMUNODEFICIENCY 27A
IL12RB1	免疫缺陷	IMMUNODEFICIENCY 27A
MCCC1	合成酶缺乏症	3-@METHYLCROTONYL-CoA CARBOXYLASE 1 DEFICIENCY
MCCC2	合成酶缺乏症	3-@METHYLCROTONYL-CoA CARBOXYLASE 2 DEFICIENCY
ABCG5	谷甾醇血症	SITOSTEROLEMIA
CYP4V2	视网膜营养不良	BIETTI CRYSTALLINE CORNEORETINAL DYSTROPHY
ATR	Seckel综合征	SECKEL SYNDROME 1
PCNT	小头骨发育不良先天性侏儒症	MICROCEPHALIC OSTEODYSPLASTIC PRIMORDIAL DWARFISM, TYPE II
EMG1	Bowen-Conradi综合征	BOWEN-CONRADI SYNDROME
SCNN1B	支气管扩张	BRONCHIECTASIS WITH OR WITHOUT ELEVATED SWEAT CHLORIDE 1
ATP8B1	进行性家族性肝内胆汁淤积症	CHOLESTASIS, PROGRESSIVE FAMILIAL INTRAHEPATIC, 1
CD96	三角头畸形综合征	C SYNDROME
NT5E	关节和动脉钙化	CALCIFICATION OF JOINTS AND ARTERIES
GALNT3	肿瘤样钙沉着症	TUMORAL CALCINOSIS, HYPERPHOSPHATEMIC, FAMILIAL
FGF23	肿瘤样钙沉着症	TUMORAL CALCINOSIS, HYPERPHOSPHATEMIC, FAMILIAL
KL	肿瘤样钙沉着症	TUMORAL CALCINOSIS, HYPERPHOSPHATEMIC, FAMILIAL
EGFR	肺癌	LUNG CANCER
BRAF	肺癌	LUNG CANCER
CARD9	念珠菌病	CANDIDIASIS, FAMILIAL, 2
PMM2	先天性糖基化障碍	CONGENITAL DISORDER OF GLYCOSYLATION, TYPE Ia
MGAT2	先天性糖基化障碍	CONGENITAL DISORDER OF GLYCOSYLATION, TYPE IIa
CPN1	水解酶缺乏症	CARBOXYPEPTIDASE N DEFICIENCY
LMNA	扩张型心肌病	CARDIOMYOPATHY, DILATED, WITH HYPERGONADOTROPIC HYPOGONADISM
SLC22A5	原发性肉碱缺乏症	CARNITINE DEFICIENCY, SYSTEMIC PRIMARY
SIX6	孤立型小眼畸形伴眼缺损	MICROPHTHALMIA, ISOLATED, WITH CATARACT 2
RAB3GAP2	Martsolf综合征	MARTSOLF SYNDROME
LRP4	CENANI-伦茨并指畸形综合征	CENANI-LENZ SYNDACTYLY SYNDROME
INPP5E	朱伯特综合征	JOUBERT SYNDROME 1
CYP27A1	脑腱性黄瘤症	CEREBROTENDINOUS XANTHOMATOSIS
PEX1	雷夫叙姆病	PEROXISOME BIOGENESIS DISORDER 1A (ZELLWEGER)
PEX2	雷夫叙姆病	PEROXISOME BIOGENESIS DISORDER 1A (ZELLWEGER)
PEX5	雷夫叙姆病	PEROXISOME BIOGENESIS DISORDER 1A (ZELLWEGER)
PEX13	雷夫叙姆病	PEROXISOME BIOGENESIS DISORDER 1A (ZELLWEGER)
PEX14	雷夫叙姆病	PEROXISOME BIOGENESIS DISORDER 1A (ZELLWEGER)
PEX16	雷夫叙姆病	PEROXISOME BIOGENESIS DISORDER 1A (ZELLWEGER)
PEX26	雷夫叙姆病	PEROXISOME BIOGENESIS DISORDER 1A (ZELLWEGER)
ERCC6	脑额骨综合征	CEREBROOCULOFACIOSKELETAL SYNDROME 1
GDAP1	腓骨肌萎缩症	CHARCOT-MARIE-TOOTH DISEASE, TYPE 4A
LYST	先天性白细胞颗粒异常综合征	CHEDIAK-HIGASHI SYNDROME
SEMA3E	CHARGE综合征	CHARGE SYNDROME
PTH1R	软骨发育异常	CHONDRODYSPLASIA, BLOMSTRAND TYPE
PEX7	软骨发育不全	RHIZOMELIC CHONDRODYSPLASIA PUNCTATA, TYPE 1
COL11A2	骨发育不良	OTOSPONDYLOMEGAEPIPHYSEAL DYSPLASIA
COL2A1	骨发育不良	OTOSPONDYLOMEGAEPIPHYSEAL DYSPLASIA
KRT8	肝硬化	CIRRHOSIS, FAMILIAL
KRT18	肝硬化	CIRRHOSIS, FAMILIAL
ASS1	瓜氨酸血症	CITRULLINEMIA, CLASSIC
ERCC8	Cockayne综合征	COCKAYNE SYNDROME A
CNNM4	Jalili综合征	JALILI SYNDROME
PLG	血纤维蛋白溶酶原缺乏症	PLASMINOGEN DEFICIENCY, TYPE I
TBX1	心脏圆锥动脉干畸形	CONOTRUNCAL HEART MALFORMATIONS
GDF1	心脏圆锥动脉干畸形	CONOTRUNCAL HEART MALFORMATIONS
KERA	扁平角膜	CORNEA PLANA 2
SLC4A11	角膜营养不良和感知性耳聋	CORNEAL DYSTROPHY AND PERCEPTIVE DEAFNESS
SLC4A11	角膜营养不良	CORNEAL ENDOTHELIAL DYSTROPHY 2, AUTOSOMAL RECESSIVE
CHST6	黄斑营养不良	MACULAR DYSTROPHY, CORNEAL, 1
SLC12A6	胼胝体发育不全及周围神经病变	AGENESIS OF THE CORPUS CALLOSUM WITH PERIPHERAL NEUROPATHY
HRAS	Costello综合征	COSTELLO SYNDROME
IFT122	颅骨外胚层发育不良	CRANIOECTODERMAL DYSPLASIA 1
PAX8	甲状腺功能减退症	HYPOTHYROIDISM, CONGENITAL, NONGOITROUS, 2
UGT1A1	Crigler-Najjar综合征	CRIGLER-NAJJAR SYNDROME, TYPE I
FRAS1	FRASER综合征	FRASER SYNDROME
FREM2	FRASER综合征	FRASER SYNDROME
INSL3	隐睾	CRYPTORCHIDISM, UNILATERAL OR BILATERAL
RXFP2	隐睾	CRYPTORCHIDISM, UNILATERAL OR BILATERAL
AIP	垂体ACTH微腺瘤	PITUITARY ADENOMA, ACTH-SECRETING
FBLN5	皮肤松弛症	CUTIS LAXA, AUTOSOMAL RECESSIVE, TYPE IA
EFEMP2	皮肤松弛症	CUTIS LAXA, AUTOSOMAL RECESSIVE, TYPE IA
ATP6V0A2	皮肤松弛症	CUTIS LAXA, AUTOSOMAL RECESSIVE, TYPE IIA
CTH	合成酶缺乏症	CYSTATHIONINURIA
CTNS	胱氨酸病	CYSTINOSIS, ADULT NONNEPHROPATHIC
CTNS	胱氨酸病	CYSTINOSIS, NEPHROPATHIC
CTNS	胱氨酸病	CYSTINOSIS, LATE-ONSET JUVENILE OR ADOLESCENT NEPHROPATHIC TYPE
SLC7A9	胱氨酸尿症	CYSTINURIA
LRPPRC	Leigh综合征	LEIGH SYNDROME, FRENCH CANADIAN TYPE
SLC22A12	肾性低尿酸血症	HYPOURICEMIA, RENAL, 1
GJB2	先天性耳聋	DEAFNESS, AUTOSOMAL RECESSIVE 1A
LHX3	联合性垂体激素缺乏症	PITUITARY HORMONE DEFICIENCY, COMBINED, 3
TYROBP	脑白质病	POLYCYSTIC LIPOMEMBRANOUS OSTEODYSPLASIA WITH SCLEROSING LEUKOENCEPHALOPATHY
TREM2	脑白质病	POLYCYSTIC LIPOMEMBRANOUS OSTEODYSPLASIA WITH SCLEROSING LEUKOENCEPHALOPATHY
WFS1	Wolfram综合征	WOLFRAM SYNDROME 1
LRP2	DONNAI-BARROW综合征	DONNAI-BARROW SYNDROME
SLC26A2	骨畸形性发育不良	DIASTROPHIC DYSPLASIA
SLC7A7	赖氨酸尿性蛋白耐受不良	LYSINURIC PROTEIN INTOLERANCE
DPYS	氧化还原酶缺乏症	DIHYDROPYRIMIDINASE DEFICIENCY
GNPAT	软骨发育不全	RHIZOMELIC CHONDRODYSPLASIA PUNCTATA, TYPE 2
SI	水解酶缺乏症	SUCRASE-ISOMALTASE DEFICIENCY, CONGENITAL
LCT	水解酶缺乏症	LACTASE DEFICIENCY, CONGENITAL
DBH	氧化还原酶缺乏症	DOPAMINE BETA-HYDROXYLASE DEFICIENCY, CONGENITAL
DYM	迪格弗-梅尔基奥尔-克劳森综合征	DYGGVE-MELCHIOR-CLAUSEN DISEASE
IKBKAP	感觉自主神经病	NEUROPATHY, HEREDITARY SENSORY AND AUTONOMIC, TYPE III
VLDLR	极低密度脂蛋白受体相关的小脑发育不全	CEREBELLAR ATAXIA, MENTAL RETARDATION, AND DYSEQUILIBRIUM SYNDROME
SEC23B	先天性红细胞生成障碍贫血	ANEMIA, CONGENITAL DYSERYTHROPOIETIC, TYPE II
CDAN1	先天性红细胞生成障碍贫血	ANEMIA, CONGENITAL DYSERYTHROPOIETIC, TYPE Ia
NOP10	先天性角化不良	DYSKERATOSIS CONGENITA, AUTOSOMAL RECESSIVE, 1
NHP2	先天性角化不良	DYSKERATOSIS CONGENITA, AUTOSOMAL RECESSIVE, 1
WNT10A	SCHOPF-SCHULZ-PASSARGE综合征	SCHOPF-SCHULZ-PASSARGE SYNDROME
EDAR	外胚层发育不良	ECTODERMAL DYSPLASIA 10B, HYPOHIDROTIC/HAIR/TOOTH TYPE, AUTOSOMAL
EDARADD	外胚层发育不良	ECTODERMAL DYSPLASIA 10B, HYPOHIDROTIC/HAIR/TOOTH TYPE, AUTOSOMAL
PVRL1	裂唇/腭外胚层发育不良综合征	CLEFT LIP/PALATE-ECTODERMAL DYSPLASIA SYNDROME
ADAMTSL4	晶状体异位	ECTOPIA LENTIS 2, ISOLATED, AUTOSOMAL RECESSIVE
NKX2-5	甲状腺功能减退症	HYPOTHYROIDISM, CONGENITAL, NONGOITROUS, 5
CDH3	外胚层发育不全,缺指(趾)畸形和黄斑营养不良综合征	ECTODERMAL DYSPLASIA, ECTRODACTYLY, AND MACULAR DYSTROPHY SYNDROME
WNT10B	手裂/足裂畸形	SPLIT-HAND/FOOT MALFORMATION 6
COL1A2	Ehlers-Danlos综合征	EHLERS-DANLOS SYNDROME, AUTOSOMAL RECESSIVE, CARDIAC VALVULAR FORM
ADAMTS2	Ehlers-Danlos综合征	EHLERS-DANLOS SYNDROME, TYPE VII, AUTOSOMAL RECESSIVE
TREX1	Aicardi-Goutieres综合征	AICARDI-GOUTIERES SYNDROME 1
TSEN54	脑桥小脑发育不全	PONTOCEREBELLAR HYPOPLASIA, TYPE 4
FLVCR2	增生性血管病和脑积水综合征	PROLIFERATIVE VASCULOPATHY AND HYDRANENCEPHALY-HYDROCEPHALY SYNDROME
TMPRSS15	肠激酶缺乏症	ENTEROKINASE DEFICIENCY
TMC6	疣状表皮发育不全	EPIDERMODYSPLASIA VERRUCIFORMIS
TMC8	疣状表皮发育不全	EPIDERMODYSPLASIA VERRUCIFORMIS
LAMB3	大疱性表皮松解症	EPIDERMOLYSIS BULLOSA, JUNCTIONAL, NON-HERLITZ TYPE
LAMC2	大疱性表皮松解症	EPIDERMOLYSIS BULLOSA, JUNCTIONAL, NON-HERLITZ TYPE
ITGB4	大疱性表皮松解症	EPIDERMOLYSIS BULLOSA, JUNCTIONAL, NON-HERLITZ TYPE
LAMB3	大疱性表皮松解症	EPIDERMOLYSIS BULLOSA, JUNCTIONAL, HERLITZ TYPE
ITGB4	交界性大疱性表皮松解症	EPIDERMOLYSIS BULLOSA JUNCTIONALIS WITH PYLORIC ATRESIA
ITGA6	交界性大疱性表皮松解症	EPIDERMOLYSIS BULLOSA JUNCTIONALIS WITH PYLORIC ATRESIA
SLC26A2	多发性骨骺发育不良	EPIPHYSEAL DYSPLASIA, MULTIPLE, 4
EIF2AK3	多发性骨骺发育不良	EPIPHYSEAL DYSPLASIA, MULTIPLE, WITH EARLY-ONSET DIABETES MELLITUS
OCA2	皮肤/头发/眼睛色素沉着	SKIN/HAIR/EYE PIGMENTATION, VARIATION IN, 1
LMAN1	凝血因子缺乏症	FACTOR V AND FACTOR VIII, COMBINED DEFICIENCY OF, 1
SLC2A2	Fanconi-Bickel综合征	FANCONI-BICKEL SYNDROME
ASAH1	法伯脂肪肉芽肿病	FARBER LIPOGRANULOMATOSIS
GNRHR	能生养的类阉人综合征	FERTILE EUNUCH SYNDROME
ANTXR2	玻璃样纤维瘤病综合征	HYALINE FIBROMATOSIS SYNDROME
GDF5	腓骨发育不全及复杂性短指畸形	FIBULAR HYPOPLASIA AND COMPLEX BRACHYDACTYLY
WNT7A	骨发育不良	FIBULAR APLASIA OR HYPOPLASIA, FEMORAL BOWING AND POLY-, SYN-, AND
KNG1	高分子量激肽原缺乏	HIGH MOLECULAR WEIGHT KININOGEN DEFICIENCY
SLC46A1	遗传性叶酸吸收不良	FOLATE MALABSORPTION, HEREDITARY
FSHB	单一性促卵泡素缺乏症	FOLLICLE-STIMULATING HORMONE DEFICIENCY, ISOLATED
FTCD	转移酶缺乏症	FORMIMINOTRANSFERASE DEFICIENCY
ZNF469	角膜脆弱综合征	BRITTLE CORNEA SYNDROME 1
FXN	Friedreich共济失调	FRIEDREICH ATAXIA 1
ALDOB	遗传性果糖不耐受症	FRUCTOSE INTOLERANCE, HEREDITARY
FBP1	水解酶缺乏症	FRUCTOSE-1,6-BISPHOSPHATASE DEFICIENCY
FUCA1	岩藻糖苷贮积症	FUCOSIDOSIS
GALK1	转移酶缺乏症	GALACTOKINASE DEFICIENCY
GALE	异构酶缺乏症	GALACTOSE EPIMERASE DEFICIENCY
GALT	半乳糖血症	GALACTOSEMIA
GCLC	溶血性贫血	GAMMA-GLUTAMYLCYSTEINE SYNTHETASE DEFICIENCY, HEMOLYTIC ANEMIA DUE
GLB1	GM1神经节糖苷	GM1-GANGLIOSIDOSIS, TYPE I
GLB1	GM1神经节糖苷	GM1-GANGLIOSIDOSIS, TYPE II
GLB1	GM1神经节糖苷	GM1-GANGLIOSIDOSIS, TYPE III
GBA	戈谢病	GAUCHER DISEASE, TYPE I
GBA	戈谢病	GAUCHER DISEASE, TYPE II
GBA	戈谢病	GAUCHER DISEASE, TYPE III
GBA	戈谢病	GAUCHER DISEASE, TYPE IIIC
ADAMTSL2	Geleophysic发育不良	GELEOPHYSIC DYSPLASIA 1
GORAB	骨结构不良性老年状皮肤病	GERODERMA OSTEODYSPLASTICUM
NLRP7	葡萄胎	HYDATIDIFORM MOLE, RECURRENT, 1
GP1BA	巨血小板综合征	BERNARD-SOULIER SYNDROME
GP1BB	巨血小板综合征	BERNARD-SOULIER SYNDROME
GP9	巨血小板综合征	BERNARD-SOULIER SYNDROME
CYP1B1	原发性先天性青光眼	GLAUCOMA 3, PRIMARY CONGENITAL, A
MYOC	原发性先天性青光眼	GLAUCOMA 3, PRIMARY CONGENITAL, A
AAAS	肾上腺皮促素抗性综合征	ACHALASIA-ADDISONIANISM-ALACRIMA SYNDROME
GCDH	戊二酸血症	GLUTARIC ACIDEMIA I
ETFA	氧化还原酶缺乏症	MULTIPLE ACYL-CoA DEHYDROGENASE DEFICIENCY
ETFB	氧化还原酶缺乏症	MULTIPLE ACYL-CoA DEHYDROGENASE DEFICIENCY
ETFDH	氧化还原酶缺乏症	MULTIPLE ACYL-CoA DEHYDROGENASE DEFICIENCY
GSS	溶血性贫血	GLUTATHIONE SYNTHETASE DEFICIENCY OF ERYTHROCYTES, HEMOLYTIC ANEMIA
SLC37A4	糖原贮积症	GLYCOGEN STORAGE DISEASE Ib
SLC37A4	糖原贮积症	GLYCOGEN STORAGE DISEASE Ic
GAA	糖原贮积症	GLYCOGEN STORAGE DISEASE II
AGL	糖原贮积症	GLYCOGEN STORAGE DISEASE III
GBE1	糖原贮积症	GLYCOGEN STORAGE DISEASE IV
PYGM	糖原贮积症	GLYCOGEN STORAGE DISEASE V
PYGL	糖原贮积症	GLYCOGEN STORAGE DISEASE VI
PFKM	糖原贮积症	GLYCOGEN STORAGE DISEASE VII
SLC5A2	肾性糖尿	RENAL GLUCOSURIA
FSHR	卵巢发育不良	OVARIAN DYSGENESIS 1
DHH	46,性反转	46,XY SEX REVERSAL 7
RAG1	联合细胞免疫和体液免疫缺陷伴肉芽肿	COMBINED CELLULAR AND HUMORAL IMMUNE DEFECTS WITH GRANULOMAS
RAG2	联合细胞免疫和体液免疫缺陷伴肉芽肿	COMBINED CELLULAR AND HUMORAL IMMUNE DEFECTS WITH GRANULOMAS
CYBA	慢性肉芽肿病	GRANULOMATOUS DISEASE, CHRONIC, AUTOSOMAL RECESSIVE, CYTOCHROME b-NEGATIVE
NCF1	慢性肉芽肿病	GRANULOMATOUS DISEASE, CHRONIC, AUTOSOMAL RECESSIVE, CYTOCHROME b-POSITIVE,
NCF2	慢性肉芽肿病	GRANULOMATOUS DISEASE, CHRONIC, AUTOSOMAL RECESSIVE, CYTOCHROME b-POSITIVE,
GCH1	高苯丙氨酸血症	HYPERPHENYLALANINEMIA, BH4-DEFICIENT, B
C7orf11	毛发硫营养不良	TRICHOTHIODYSTROPHY, NONPHOTOSENSITIVE 1
SLC6A19	遗传性菸酸缺乏症	HARTNUP DISORDER
COL1A2	成骨不全症	OSTEOGENESIS IMPERFECTA, TYPE IV
CCBE1	淋巴水肿综合征	HENNEKAM LYMPHANGIECTASIA-LYMPHEDEMA SYNDROME 1
AKR1D1	先天性胆汁酸合成缺陷	BILE ACID SYNTHESIS DEFECT, CONGENITAL, 2
HAL	组胺酸血症	HISTIDINEMIA
CBS	高胱氨酸尿症	HOMOCYSTINURIA DUE TO CYSTATHIONINE BETA-SYNTHASE DEFICIENCY
MTHFR	高胱氨酸尿症	HOMOCYSTINURIA DUE TO DEFICIENCY OF N(5,10)-METHYLENETETRAHYDROFOLATE
POMT1	肌营养不良-抗肌萎缩相关糖蛋白病	MUSCULAR DYSTROPHY-DYSTROGLYCANOPATHY (CONGENITAL WITH BRAIN AND EYE
HYLS1	HYDROLETHALUS综合征	HYDROLETHALUS SYNDROME 1
MKKS	麦-考二氏综合征	MCKUSICK-KAUFMAN SYNDROME
HPSE2	UROFACIAL综合征	UROFACIAL SYNDROME 1
L2HGDH	戊二酸尿症	L-2-HYDROXYGLUTARIC ACIDURIA
CPS1	合成酶缺乏症	CARBAMOYL PHOSPHATE SYNTHETASE I DEFICIENCY, HYPERAMMONEMIA DUE TO
NAGS	合成酶缺乏症	N-ACETYLGLUTAMATE SYNTHASE DEFICIENCY
ABCC2	Dubin-Johnson综合征	DUBIN-JOHNSON SYNDROME
UGT1A1	家族性高胆红素血症	HYPERBILIRUBINEMIA, TRANSIENT FAMILIAL NEONATAL
LPL	高脂蛋白血症	HYPERLIPOPROTEINEMIA, TYPE I
SLC25A15	高鸟氨酸血症-高氨血症-高瓜氨酸血症综合征	HYPERORNITHINEMIA-HYPERAMMONEMIA-HOMOCITRULLINURIA SYNDROME
TNFRSF11B	佩吉特病	PAGET DISEASE, JUVENILE
CASR	甲状旁腺功能亢进症	HYPERPARATHYROIDISM, NEONATAL SEVERE
PRODH	血脯氨酸过多症	HYPERPROLINEMIA, TYPE I
AIRE	多腺体自身免疫综合征	AUTOIMMUNE POLYENDOCRINE SYNDROME, TYPE I, WITH OR WITHOUT REVERSIBLE
TNFRSF13B	常见变异型免疫缺陷病	IMMUNODEFICIENCY, COMMON VARIABLE, 2
GYS2	糖原贮积症	GLYCOGEN STORAGE DISEASE 0, LIVER
ABCC8	亮氨酸诱导性低血糖	HYPOGLYCEMIA, LEUCINE-INDUCED
KCNJ1	Bartter综合征	BARTTER SYNDROME, ANTENATAL, TYPE 2
TBCE	甲状旁腺功能低下形态异常综合征	HYPOPARATHYROIDISM-RETARDATION-DYSMORPHISM SYNDROME
ALPL	低磷酸酯酶症	HYPOPHOSPHATASIA, INFANTILE
ALPL	低磷酸酯酶症	HYPOPHOSPHATASIA, CHILDHOOD
DMP1	低磷酸盐血症性佝偻病	HYPOPHOSPHATEMIC RICKETS, AUTOSOMAL RECESSIVE, 1
SLC34A3	低磷酸盐血症性佝偻病	HYPOPHOSPHATEMIC RICKETS WITH HYPERCALCIURIA, HEREDITARY
GJA1	左心发育不良综合征	HYPOPLASTIC LEFT HEART SYNDROME 1
B2M	分解亢进低蛋白血症	HYPOPROTEINEMIA, HYPERCATABOLIC
FOXE1	原发性甲减伴腭裂	HYPOTHYROIDISM, THYROIDAL OR ATHYROIDAL, WITH SPIKY HAIR AND CLEFT
TGM1	鱼鳞病	ICHTHYOSIS, CONGENITAL, AUTOSOMAL RECESSIVE 2
ALOXE3	鱼鳞病	ICHTHYOSIS, CONGENITAL, AUTOSOMAL RECESSIVE 2
TGM1	鱼鳞病	ICHTHYOSIS, CONGENITAL, AUTOSOMAL RECESSIVE 1
ABCA12	鱼鳞病	ICHTHYOSIS, CONGENITAL, AUTOSOMAL RECESSIVE 4B
SLC6A20	亚氨基甘氨酸尿症	IMINOGLYCINURIA
DNMT3B	免疫缺陷-着丝粒不稳定-面部异常综合征	IMMUNODEFICIENCY-CENTROMERIC INSTABILITY-FACIAL ANOMALIES SYNDROME
SMARCAL1	骨发育不良	IMMUNOOSSEOUS DYSPLASIA, SCHIMKE TYPE
SCN9A	先天性无疼痛	INDIFFERENCE TO PAIN, CONGENITAL, AUTOSOMAL RECESSIVE
AURKC	生精障碍	SPERMATOGENIC FAILURE 5
ATP8B1	良性复发性肝内胆汁淤积	CHOLESTASIS, BENIGN RECURRENT INTRAHEPATIC, 1
NAT2	乙酰化，缓慢	ACETYLATION, SLOW
IVD	异戊酸血症	ISOVALERIC ACIDEMIA
DOCK8	高IgE反复感染综合征	HYPER-IgE RECURRENT INFECTION SYNDROME, AUTOSOMAL RECESSIVE
UBR1	Johanson-Blizzard综合征	JOHANSON-BLIZZARD SYNDROME
PROKR2	Kallmann综合征	HYPOGONADOTROPIC HYPOGONADISM 3 WITH OR WITHOUT ANOSMIA
CTSC	掌跖角化-牙周病综合征	PAPILLON-LEFEVRE SYNDROME
CTSC	Haim-Munk综合征	HAIM-MUNK SYNDROME
OXCT1	转移酶缺乏症	SUCCINYL-CoA:3-OXOACID CoA TRANSFERASE DEFICIENCY
MGP	Keutel综合征	KEUTEL SYNDROME
GALC	Krabbe病	KRABBE DISEASE
SLC16A1	红细胞乳酸盐转运缺陷	ERYTHROCYTE LACTATE TRANSPORTER DEFECT
DLAT	氧化还原酶缺乏症	PYRUVATE DEHYDROGENASE E2 DEFICIENCY
PDHX	氧化还原酶缺乏症	PYRUVATE DEHYDROGENASE E3-BINDING PROTEIN DEFICIENCY
SUCLG1	线粒体DNA缺失综合征	MITOCHONDRIAL DNA DEPLETION SYNDROME 9 (ENCEPHALOMYOPATHIC TYPE WITH
STAT5B	伴免疫系统缺陷的生长激素不敏感综合征	GROWTH HORMONE INSENSITIVITY WITH IMMUNODEFICIENCY
LCAT	转移酶缺乏症	LECITHIN:CHOLESTEROL ACYLTRANSFERASE DEFICIENCY
INSR	妖精貌综合征	DONOHUE SYNDROME
LMF1	混合型脂酶缺陷症	LIPASE DEFICIENCY, COMBINED
SAR1B	乳糜微粒潴留性疾病	CHYLOMICRON RETENTION DISEASE
ECM1	Urbach-Wiethe类脂蛋白沉积症	LIPOID PROTEINOSIS OF URBACH AND WIETHE
CLDN19	低镁血症	HYPOMAGNESEMIA 5, RENAL, WITH OCULAR INVOLVEMENT
ABCA4	黄色斑点状眼底	STARGARDT DISEASE 1
CNGB3	黄色斑点状眼底	STARGARDT DISEASE 1
CLDN16	低镁血症	HYPOMAGNESEMIA 3, RENAL
SLURP1	掌跖角化症	MAL DE MELEDA
MLYCD	氧化还原酶缺乏症	MALONYL-CoA DECARBOXYLASE DEFICIENCY
LMNA	颅骨下颌骨皮肤发育不全	MANDIBULOACRAL DYSPLASIA WITH TYPE A LIPODYSTROPHY
POLR1C	下颌面骨发育不全	TREACHER COLLINS SYNDROME 3
MAN2B1	水解酶缺乏症	MANNOSIDOSIS, ALPHA B, LYSOSOMAL
MANBA	水解酶缺乏症	MANNOSIDOSIS, BETA A, LYSOSOMAL
BCKDHB	枫糖尿症	MAPLE SYRUP URINE DISEASE
DBT	枫糖尿症	MAPLE SYRUP URINE DISEASE
DLD	枫糖尿症	MAPLE SYRUP URINE DISEASE
SIL1	马-斯二氏综合征	MARINESCO-SJOGREN SYNDROME
MEFV	家族性地中海热	FAMILIAL MEDITERRANEAN FEVER
SLC19A2	巨幼细胞性贫血	THIAMINE-RESPONSIVE MEGALOBLASTIC ANEMIA SYNDROME
PSAP	脑白质营养不良	METACHROMATIC LEUKODYSTROPHY DUE TO SAPOSIN B DEFICIENCY
ARSA	脑白质营养不良	METACHROMATIC LEUKODYSTROPHY
HIBCH	β氧基异丁辅酶A缺乏症	BETA-HYDROXYISOBUTYRYL CoA DEACYLASE DEFICIENCY
CYB5R3	高铁血红蛋白血症	METHEMOGLOBINEMIA DUE TO DEFICIENCY OF METHEMOGLOBIN REDUCTASE
MAT1A	转移酶缺乏症	METHIONINE ADENOSYLTRANSFERASE DEFICIENCY
MTR	高铁血红蛋白血症	HOMOCYSTINURIA-MEGALOBLASTIC ANEMIA, cblG COMPLEMENTATION TYPE
AUH	三甲基戊烯二酸尿症	3-@METHYLGLUTACONIC ACIDURIA, TYPE I
MUT	甲基丙二酸尿症	METHYLMALONIC ACIDURIA DUE TO METHYLMALONYL-CoA MUTASE DEFICIENCY
MMAA	甲基丙二酸尿症	METHYLMALONIC ACIDURIA, cblA TYPE
MMAB	甲基丙二酸尿症	METHYLMALONIC ACIDURIA, cblB TYPE
MCEE	异构酶缺乏症	METHYLMALONYL-CoA EPIMERASE DEFICIENCY
MCPH1	常染色体隐性遗传原发性小头畸形	MICROCEPHALY 1, PRIMARY, AUTOSOMAL RECESSIVE
NBN	NIJMEGEN断裂综合征	NIJMEGEN BREAKAGE SYNDROME
OCLN	PSEUDO-TORCH综合征	BAND-LIKE CALCIFICATION WITH SIMPLIFIED GYRATION AND POLYMICROGYRIA
MYO5B	腹泻	DIARRHEA 2, WITH MICROVILLUS ATROPHY
DGUOK	线粒体DNA缺失综合征	MITOCHONDRIAL DNA DEPLETION SYNDROME 3 (HEPATOCEREBRAL TYPE)
SDHAF1	线粒体复合物缺乏症	MITOCHONDRIAL COMPLEX II DEFICIENCY
MOCS2	鉬辅酶缺乏症	MOLYBDENUM COFACTOR DEFICIENCY, COMPLEMENTATION GROUP A
MOCS1	鉬辅酶缺乏症	MOLYBDENUM COFACTOR DEFICIENCY, COMPLEMENTATION GROUP A
GPHN	鉬辅酶缺乏症	MOLYBDENUM COFACTOR DEFICIENCY, COMPLEMENTATION GROUP A
GNPTAB	粘脂贮积病	MUCOLIPIDOSIS III ALPHA/BETA
MCOLN1	粘脂贮积病	MUCOLIPIDOSIS IV
SGSH	粘多糖贮积症	MUCOPOLYSACCHARIDOSIS, TYPE IIIA
NAGLU	粘多糖贮积症	MUCOPOLYSACCHARIDOSIS, TYPE IIIB
HGSNAT	粘多糖贮积症	MUCOPOLYSACCHARIDOSIS, TYPE IIIC
GNS	粘多糖贮积症	MUCOPOLYSACCHARIDOSIS, TYPE IIID
GALNS	粘多糖贮积症	MUCOPOLYSACCHARIDOSIS, TYPE IVA
GLB1	粘多糖贮积症	MUCOPOLYSACCHARIDOSIS TYPE IVB
ARSB	粘多糖贮积症	MUCOPOLYSACCHARIDOSIS TYPE VI
GUSB	粘多糖贮积症	MUCOPOLYSACCHARIDOSIS, TYPE VII
TRIM37	穆利布瑞侏儒综合征	MULIBREY NANISM
BTD	合成酶缺乏症	BIOTINIDASE DEFICIENCY
HLCS	合成酶缺乏症	HOLOCARBOXYLASE SYNTHETASE DEFICIENCY
POMGNT1	肌营养不良-抗肌萎缩相关糖蛋白病	MUSCULAR DYSTROPHY-DYSTROGLYCANOPATHY (CONGENITAL WITH BRAIN AND EYE
CHRNA1	多发性翼状膜综合征	MULTIPLE PTERYGIUM SYNDROME, LETHAL TYPE
CHRND	多发性翼状膜综合征	MULTIPLE PTERYGIUM SYNDROME, LETHAL TYPE
CHRNG	多发性翼状膜综合征	MULTIPLE PTERYGIUM SYNDROME, LETHAL TYPE
SMN1	脊髓性肌萎缩症	SPINAL MUSCULAR ATROPHY, TYPE I
GLE1	先天致死性挛缩综合征	LETHAL CONGENITAL CONTRACTURE SYNDROME 1
SMN1	脊髓性肌萎缩症	SPINAL MUSCULAR ATROPHY, TYPE III
SMN1	脊髓性肌萎缩症	SPINAL MUSCULAR ATROPHY, TYPE II
COL6A3	先天性肌营养不良	ULLRICH CONGENITAL MUSCULAR DYSTROPHY
COL6A2	先天性肌营养不良	ULLRICH CONGENITAL MUSCULAR DYSTROPHY
TRIM32	肌营养不良	MUSCULAR DYSTROPHY, LIMB-GIRDLE, TYPE 2H
CHAT	肌无力综合征	MYASTHENIC SYNDROME, CONGENITAL, ASSOCIATED WITH EPISODIC APNEA
LIG4	多发性骨髓瘤	MYELOMA, MULTIPLE
MPO	氧化还原酶缺乏症	MYELOPEROXIDASE DEFICIENCY
NHLRC1	癫痫	MYOCLONIC EPILEPSY OF LAFORA
EPM2A	癫痫	MYOCLONIC EPILEPSY OF LAFORA
CSTB	Unverricht-Lundborg肌阵挛性癫痫	MYOCLONIC EPILEPSY OF UNVERRICHT AND LUNDBORG
SCARB2	癫痫	EPILEPSY, PROGRESSIVE MYOCLONIC, 4, WITH OR WITHOUT RENAL FAILURE
CPT2	转移酶缺乏症	CARNITINE PALMITOYLTRANSFERASE II DEFICIENCY, LATE-ONSET
CPT1A	转移酶缺乏症	CARNITINE PALMITOYLTRANSFERASE I DEFICIENCY
ISCU	遗传性肌病伴乳酸性酸中毒	MYOPATHY WITH LACTIC ACIDOSIS, HEREDITARY
BIN1	中央核性肌病	MYOPATHY, CENTRONUCLEAR, 2
ACTA1	先天性肌病	MYOPATHY, CONGENITAL, WITH FIBER-TYPE DISPROPORTION
SEPN1	先天性肌病	MYOPATHY, CONGENITAL, WITH FIBER-TYPE DISPROPORTION
TPM3	先天性肌病	MYOPATHY, CONGENITAL, WITH FIBER-TYPE DISPROPORTION
RYR1	中央轴空病/微轴空病	MINICORE MYOPATHY WITH EXTERNAL OPHTHALMOPLEGIA
CLCN1	肌强直症	MYOTONIA CONGENITA, AUTOSOMAL RECESSIVE
HSPG2	施-詹二氏综合征:睑裂狭小-肌痛-侏儒综合征	SCHWARTZ-JAMPEL SYNDROME, TYPE 1
SLC26A2	骨发育不全症	ATELOSTEOGENESIS, TYPE II
NPHP1	肾消耗病	NEPHRONOPHTHISIS 1
NPHS1	肾病综合征	NEPHROTIC SYNDROME, TYPE 1
WT1	肾病综合征	NEPHROTIC SYNDROME, TYPE 4
ABCC8	高胰岛素低血糖症	HYPERINSULINEMIC HYPOGLYCEMIA, FAMILIAL, 1
SPINK5	鱼鳞病	NETHERTON SYNDROME
CTSA	半乳糖唾液酸沉积症	GALACTOSIALIDOSIS
NEU1	水解酶缺乏症	NEURAMINIDASE DEFICIENCY
PLA2G6	大脑铁沉积性神经退行性变	NEURODEGENERATION WITH BRAIN IRON ACCUMULATION 2A
KIF1B	神经母细胞瘤易感性	NEUROBLASTOMA, SUSCEPTIBILITY TO
CLN5	神经元蜡样质脂褐质沉积症	CEROID LIPOFUSCINOSIS, NEURONAL, 5
NTRK1	先天性痛觉不敏感并无汗症	INSENSITIVITY TO PAIN, CONGENITAL, WITH ANHIDROSIS
MPV17	线粒体DNA缺失综合征	MITOCHONDRIAL DNA DEPLETION SYNDROME 6 (HEPATOCEREBRAL TYPE)
CCT5	感觉自主神经病	NEUROPATHY, HEREDITARY SENSORY, WITH SPASTIC PARAPLEGIA, AUTOSOMAL
GAN	巨轴索神经病变	GIANT AXONAL NEUROPATHY 1, AUTOSOMAL RECESSIVE
SMPD1	尼曼-皮克病(鞘磷脂沉积病)	NIEMANN-PICK DISEASE, TYPE A
NPC1	尼曼-皮克病(鞘磷脂沉积病)	NIEMANN-PICK DISEASE, TYPE C1
GRM6	先天性静止性夜盲症	NIGHT BLINDNESS, CONGENITAL STATIONARY, TYPE 1B
BUB1B	斑花叶非整倍体综合征	MOSAIC VARIEGATED ANEUPLOIDY SYNDROME 1
RELN	无脑回畸形	LISSENCEPHALY 2
GJA1	眼齿指发育不良	OCULODENTODIGITAL DYSPLASIA, AUTOSOMAL RECESSIVE
WNT10A	牙齿,指甲和皮肤发育不良综合征	ODONTOONYCHODERMAL DYSPLASIA
GPC6	肩发育不良	OMODYSPLASIA 1
POLG	进行性眼外肌麻痹	PROGRESSIVE EXTERNAL OPHTHALMOPLEGIA WITH MITOCHONDRIAL DNA DELETIONS,
OPA3	三甲基戊烯二酸尿症	3-@METHYLGLUTACONIC ACIDURIA, TYPE III
OAT	回旋状脉络膜视网膜萎缩	GYRATE ATROPHY OF CHOROID AND RETINA
HPGD	原发性肥大性骨关节病	HYPERTROPHIC OSTEOARTHROPATHY, PRIMARY, AUTOSOMAL RECESSIVE, 1
COL1A1	成骨不全症	OSTEOGENESIS IMPERFECTA, TYPE III
PPIB	成骨不全症	OSTEOGENESIS IMPERFECTA, TYPE IX
TP53	成骨肉瘤	OSTEOGENIC SARCOMA
TCIRG1	骨硬化病	OSTEOPETROSIS, AUTOSOMAL RECESSIVE 1
TNFSF11	骨硬化病	OSTEOPETROSIS, AUTOSOMAL RECESSIVE 2
OSTM1	骨硬化病	OSTEOPETROSIS, AUTOSOMAL RECESSIVE 5
CA2	骨硬化病	OSTEOPETROSIS, AUTOSOMAL RECESSIVE 3
LRP5	骨质疏松症-假神经胶质瘤综合征	OSTEOPOROSIS-PSEUDOGLIOMA SYNDROME
FAM20C	RAINE综合征	RAINE SYNDROME
AGXT	转移酶缺乏症	HYPEROXALURIA, PRIMARY, TYPE I
GRHPR	转移酶缺乏症	HYPEROXALURIA, PRIMARY, TYPE II
FBXO7	遗传性帕金森病	PARKINSON DISEASE 15, AUTOSOMAL RECESSIVE EARLY-ONSET
PDX1	胰腺发育不全	PANCREATIC AGENESIS 1
TBX15	COUSIN综合征	COUSIN SYNDROME
MVK	高IgD综合征	HYPER-IgD SYNDROME
GIF	内因子缺乏症	INTRINSIC FACTOR DEFICIENCY
CUBN	巨幼细胞性贫血	MEGALOBLASTIC ANEMIA 1
AMN	巨幼细胞性贫血	MEGALOBLASTIC ANEMIA 1
EPX	嗜酸性粒细胞过氧化物酶和磷脂缺乏症	EOSINOPHIL PEROXIDASE DEFICIENCY
HSD17B4	D-双功能蛋白缺乏	D-BIFUNCTIONAL PROTEIN DEFICIENCY
B3GALTL	Peters-Plus综合征	PETERS-PLUS SYNDROME
AMH	持久苗勒管综合征	PERSISTENT MULLERIAN DUCT SYNDROME, TYPES I AND II
PAH	高苯丙氨酸血症	PHENYLKETONURIA
QDPR	高苯丙氨酸血症	HYPERPHENYLALANINEMIA, BH4-DEFICIENT, C
PTS	高苯丙氨酸血症	HYPERPHENYLALANINEMIA, BH4-DEFICIENT, A
PGAM2	糖原贮积症	GLYCOGEN STORAGE DISEASE X
PRKAG2	糖原贮积症	GLYCOGEN STORAGE DISEASE OF HEART, LETHAL CONGENITAL
PHKB	糖原贮积症	GLYCOGEN STORAGE DISEASE IXb
BCS1L	Bjornstad综合征	BJORNSTAD SYNDROME
GHR	Laron综合征	LARON SYNDROME
PROP1	联合性垂体激素缺乏症	PITUITARY HORMONE DEFICIENCY, COMBINED, 2
GH1	川崎病	KOWARSKI SYNDROME
LHX4	联合性垂体激素缺乏症	PITUITARY HORMONE DEFICIENCY, COMBINED, 4
SERPINF2	α-2-纤溶酶抑制物缺乏症	ALPHA-2-PLASMIN INHIBITOR DEFICIENCY
ANO6	斯科格综合征	SCOTT SYNDROME
TSHR	甲状腺功能减退症	HYPOTHYROIDISM, CONGENITAL, NONGOITROUS, 1
VHL	家族性红细胞增多症	ERYTHROCYTOSIS, FAMILIAL, 2
DYNC2H1	短肋多指畸形综合征	SHORT RIB-POLYDACTYLY SYNDROME, TYPE III
DYNC2H1	窒息性胸廓发育不良	SHORT-RIB THORACIC DYSPLASIA 6 WITH OR WITHOUT POLYDACTYLY
GBE1	葡聚糖体病	POLYGLUCOSAN BODY NEUROPATHY, ADULT FORM
UROS	卟啉病	PORPHYRIA, CONGENITAL ERYTHROPOIETIC
SLC12A3	GITELMAN综合征	GITELMAN SYNDROME
PCBD1	高苯丙氨酸血症	HYPERPHENYLALANINEMIA, BH4-DEFICIENT, D
HSD17B3	氧化还原酶缺乏症	17-@BETA HYDROXYSTEROID DEHYDROGENASE III DEFICIENCY
ACOX1	氧化还原酶缺乏症	PEROXISOMAL ACYL-CoA OXIDASE DEFICIENCY
SRD5A2	假阴道会阴尿道下裂	PSEUDOVAGINAL PERINEOSCROTAL HYPOSPADIAS
CYP27B1	维生素D缺乏性佝偻病	VITAMIN D HYDROXYLATION-DEFICIENT RICKETS, TYPE 1A
ABCC6	弹性假黄瘤	PSEUDOXANTHOMA ELASTICUM
CHRNG	多发性翼状膜综合征	MULTIPLE PTERYGIUM SYNDROME, ESCOBAR VARIANT
SFTPB	肺表面活性物质代谢功能障碍	SURFACTANT METABOLISM DYSFUNCTION, PULMONARY, 1
FOXF1	肺泡毛细血管发育异常伴肺静脉错位	ALVEOLAR CAPILLARY DYSPLASIA WITH MISALIGNMENT OF PULMONARY VEINS
BMPR2	肺静脉闭塞病	PULMONARY VENOOCCLUSIVE DISEASE 1, AUTOSOMAL DOMINANT
CTSK	骨发育不良	PYCNODYSOSTOSIS
ALDH7A1	癫痫	EPILEPSY, PYRIDOXINE-DEPENDENT
NT5C3	溶血性贫血	URIDINE 5-PRIME MONOPHOSPHATE HYDROLASE DEFICIENCY, HEMOLYTIC ANEMIA
GSS	合成酶缺乏症	GLUTATHIONE SYNTHETASE DEFICIENCY
SPTA1	遗传性变性异形红细胞增多症	PYROPOIKILOCYTOSIS, HEREDITARY
PC	合成酶缺乏症	PYRUVATE CARBOXYLASE DEFICIENCY
PKLR	转移酶缺乏症	PYRUVATE KINASE DEFICIENCY OF RED CELLS
SLC35C1	先天性糖基化障碍	CONGENITAL DISORDER OF GLYCOSYLATION, TYPE IIc
RECQL4	桡骨髌骨不发育综合征	RAPADILINO SYNDROME
MC1R	皮肤/头发/眼睛色素沉着	SKIN/HAIR/EYE PIGMENTATION, VARIATION IN, 2
PHYH	雷夫叙姆病	REFSUM DISEASE, CLASSIC
PEX7	雷夫叙姆病	REFSUM DISEASE, CLASSIC
PEX1	雷夫叙姆病	PEROXISOME BIOGENESIS DISORDER 3B
PEX2	雷夫叙姆病	PEROXISOME BIOGENESIS DISORDER 3B
PEX26	雷夫叙姆病	PEROXISOME BIOGENESIS DISORDER 3B
ATP6V1B1	肾小管酸中毒	RENAL TUBULAR ACIDOSIS, DISTAL, WITH PROGRESSIVE NERVE DEAFNESS
REN	肾小管发育不良	RENAL TUBULAR DYSGENESIS
AGT	肾小管发育不良	RENAL TUBULAR DYSGENESIS
AGTR1	肾小管发育不良	RENAL TUBULAR DYSGENESIS
ACE	肾小管发育不良	RENAL TUBULAR DYSGENESIS
SPATA7	视网膜色素变性	RETINITIS PIGMENTOSA
NR2E3	增强S视锥综合征	ENHANCED S-CONE SYNDROME
TINF2	Revesz综合征	REVESZ SYNDROME
RHAG	Rh无效型抑制型	RH-NULL, REGULATOR TYPE
LPIN1	反复性肌红蛋白尿	MYOGLOBINURIA, ACUTE RECURRENT, AUTOSOMAL RECESSIVE
ESCO2	罗伯茨综合征	ROBERTS SYNDROME
ROR2	Robinow综合征	ROBINOW SYNDROME, AUTOSOMAL RECESSIVE
HEXB	山德霍夫氏病	SANDHOFF DISEASE
ESCO2	SC海豹肢畸形综合征	SC PHOCOMELIA SYNDROME
SHH	脑裂畸形	SCHIZENCEPHALY
SLC35D1	Schneckenbecken发育不良	SCHNECKENBECKEN DYSPLASIA
SOST	硬化性骨化病	SCLEROSTEOSIS 1
SLC17A5	婴儿唾液酸贮积病	INFANTILE SIALIC ACID STORAGE DISEASE
GNE	唾液酸尿症	SIALURIA
NODAL	内脏异位	HETEROTAXY, VISCERAL, 5, AUTOSOMAL
ALDH3A2	鱼鳞病	SJOGREN-LARSSON SYNDROME
DHCR7	遗传性胆固醇合成缺陷:史-伦-奥三氏综合征	SMITH-LEMLI-OPITZ SYNDROME
SPINT2	腹泻	DIARRHEA 3, SECRETORY SODIUM, CONGENITAL, WITH OR WITHOUT OTHER CONGENITAL
IGF1R	抗胰岛素样生长因子Ⅰ	INSULIN-LIKE GROWTH FACTOR I, RESISTANCE TO
SACS	痉挛性共济失调	SPASTIC ATAXIA, CHARLEVOIX-SAGUENAY TYPE
BSCL2	遗传性痉挛性截瘫	SPASTIC PARAPLEGIA 17, AUTOSOMAL DOMINANT
ZFYVE26	遗传性痉挛性截瘫	SPASTIC PARAPLEGIA 15, AUTOSOMAL RECESSIVE
CYP7B1	遗传性痉挛性截瘫	SPASTIC PARAPLEGIA 5A, AUTOSOMAL RECESSIVE
SYCP3	生精障碍	SPERMATOGENIC FAILURE 4
SPTA1	球形红细胞增多症	SPHEROCYTOSIS, TYPE 3
C10orf2	线粒体DNA缺失综合征	MITOCHONDRIAL DNA DEPLETION SYNDROME 7 (HEPATOCEREBRAL TYPE)
DDR2	脊椎干骺端发育不良	SPONDYLOMETAEPIPHYSEAL DYSPLASIA, SHORT LIMB-HAND TYPE
ASPA	Canavan病	CANAVAN DISEASE
NUP62	婴儿纹状体黑质变性	STRIATONIGRAL DEGENERATION, INFANTILE
ALDH5A1	氧化还原酶缺乏症	SUCCINIC SEMIALDEHYDE DEHYDROGENASE DEFICIENCY
SCN5A	婴儿猝死综合征	SUDDEN INFANT DEATH SYNDROME
SUMF1	水解酶缺乏症	MULTIPLE SULFATASE DEFICIENCY
SUOX	胱氨酸尿症	SULFOCYSTEINURIA
CRLF1	冷诱导出汗综合征	COLD-INDUCED SWEATING SYNDROME 1
FLNB	椎囊骨性联接综合征	SPONDYLOCARPOTARSAL SYNOSTOSIS SYNDROME
GM2A	GM2神经节苷脂贮积症	GM2-GANGLIOSIDOSIS, AB VARIANT
HEXA	Tay-Sachs病	TAY-SACHS DISEASE
WNT3	先天性四肢切断症	TETRAAMELIA SYNDROME, AUTOSOMAL RECESSIVE
CUL7	3M综合征	THREE M SYNDROME 1
ITGA2B	血小板机能不全症	GLANZMANN THROMBASTHENIA
ITGB3	血小板机能不全症	GLANZMANN THROMBASTHENIA
ADAMTS13	血栓性血小板减少性紫癜	THROMBOTIC THROMBOCYTOPENIC PURPURA, CONGENITAL
DPYD	氧化还原酶缺乏症	DIHYDROPYRIMIDINE DEHYDROGENASE DEFICIENCY
THRB	甲状腺激素抵抗综合征	THYROID HORMONE RESISTANCE, GENERALIZED, AUTOSOMAL RECESSIVE
SLC5A5	甲状腺激素生成障碍	THYROID DYSHORMONOGENESIS 1
TPO	甲状腺激素生成障碍	THYROID DYSHORMONOGENESIS 2A
SLC26A4	甲状腺耳聋综合征	PENDRED SYNDROME
TG	甲状腺激素生成障碍	THYROID DYSHORMONOGENESIS 3
IYD	甲状腺激素生成障碍	THYROID DYSHORMONOGENESIS 4
DUOXA2	甲状腺激素生成障碍	THYROID DYSHORMONOGENESIS 5
TSHB	甲状腺功能减退症	HYPOTHYROIDISM, CONGENITAL, NONGOITROUS, 4
LMNA	致死性限制性真皮病	RESTRICTIVE DERMOPATHY, LETHAL
HBB	地中海贫血	BETA-THALASSEMIA
ABHD5	CHANARIN-DORFMAN综合征	CHANARIN-DORFMAN SYNDROME
SPG20	遗传性痉挛性截瘫	SPASTIC PARAPLEGIA 20, AUTOSOMAL RECESSIVE
MLH1	错配修复癌综合征	MISMATCH REPAIR CANCER SYNDROME
MSH2	错配修复癌综合征	MISMATCH REPAIR CANCER SYNDROME
PMS2	错配修复癌综合征	MISMATCH REPAIR CANCER SYNDROME
TAT	水解酶缺乏症	TYROSINEMIA, TYPE II
HPD	水解酶缺乏症	TYROSINEMIA, TYPE III
WNT7A	尺骨腓骨缺如-重度四肢缺陷综合症	ULNA AND FIBULA, ABSENCE OF, WITH SEVERE LIMB DEFICIENCY
MYO7A	尤塞氏综合症	USHER SYNDROME, TYPE I
USH2A	尤塞氏综合症	USHER SYNDROME, TYPE IIA
CLRN1	尤塞氏综合症	USHER SYNDROME, TYPE IIIA
USH1C	尤塞氏综合症	USHER SYNDROME, TYPE IC
PTEN	VACTERL综合征	VACTERL ASSOCIATION WITH HYDROCEPHALUS
CFTR	先天性双侧输精管缺如	VAS DEFERENS, CONGENITAL BILATERAL APLASIA OF
DLL3	脊椎肋骨发育不全	SPONDYLOCOSTAL DYSOSTOSIS 1, AUTOSOMAL RECESSIVE
LMBRD1	甲基丙二酸尿症	METHYLMALONIC ACIDURIA AND HOMOCYSTINURIA, cblF TYPE
MMACHC	甲基丙二酸尿症	METHYLMALONIC ACIDURIA AND HOMOCYSTINURIA, cblC TYPE
MMADHC	甲基丙二酸尿症	METHYLMALONIC ACIDURIA AND HOMOCYSTINURIA, cblD TYPE
VDR	维生素D缺乏性佝偻病	VITAMIN D-DEPENDENT RICKETS, TYPE 2A
GGCX	维生素K依赖性联合凝血因子缺乏症	VITAMIN K-DEPENDENT CLOTTING FACTORS, COMBINED DEFICIENCY OF, 1
TSEN54	脑桥小脑发育不全	PONTOCEREBELLAR HYPOPLASIA, TYPE 2A
VWF	血管性血友病	VON WILLEBRAND DISEASE, TYPE 3
EDNRB	瓦登伯革氏症候群	WAARDENBURG SYNDROME, TYPE 4A
EZH2	韦弗综合征	WEAVER SYNDROME
ADAMTS10	Weill-Marchesani综合征	WEILL-MARCHESANI SYNDROME 1
WRN	早老症	WERNER SYNDROME
LIPA	水解酶缺乏症	LYSOSOMAL ACID LIPASE DEFICIENCY
LPAR6	常染色体隐性遗传性羊毛状发1	HYPOTRICHOSIS 8
XDH	黄嘌呤尿症	XANTHINURIA, TYPE I
XPA	着色性干皮病	XERODERMA PIGMENTOSUM, COMPLEMENTATION GROUP A
XPC	着色性干皮病	XERODERMA PIGMENTOSUM, COMPLEMENTATION GROUP C
DDB2	着色性干皮病	XERODERMA PIGMENTOSUM, COMPLEMENTATION GROUP E
POLH	着色性干皮病	XERODERMA PIGMENTOSUM, VARIANT TYPE
ERCC4	着色性干皮病	XERODERMA PIGMENTOSUM, COMPLEMENTATION GROUP F
ERCC5	着色性干皮病	XERODERMA PIGMENTOSUM, COMPLEMENTATION GROUP G
ERCC6	着色性干皮病痴呆综合征	DE SANCTIS-CACCHIONE SYNDROME
MID1	OPITZ GBBB综合征	OPITZ GBBB SYNDROME, X-LINKED
ARX	胼胝体发育不全伴生殖器异常	CORPUS CALLOSUM, AGENESIS OF, WITH ABNORMAL GENITALIA
RPGR	视网膜色素变性	RETINITIS PIGMENTOSA 3
FLNA	脑室周围结节型异位	HETEROTOPIA, PERIVENTRICULAR, X-LINKED DOMINANT
MECP2	X连锁智力低下	MENTAL RETARDATION, X-LINKED, SYNDROMIC 13
DCX	无脑回畸形	LISSENCEPHALY, X-LINKED, 1
AR	雄激素不敏感综合征	ANDROGEN INSENSITIVITY SYNDROME
CACNA1F	先天性静止性夜盲症	NIGHT BLINDNESS, CONGENITAL STATIONARY, TYPE 2A
PCDH19	癫痫	EPILEPTIC ENCEPHALOPATHY, EARLY INFANTILE, 9
IL1RAPL1	X连锁智力低下	MENTAL RETARDATION, X-LINKED 21
BCOR	小眼畸形综合征	MICROPHTHALMIA, SYNDROMIC 2
TAZ	巴氏综合征	BARTH SYNDROME
NR0B1	肾上腺发育不良	ADRENAL HYPOPLASIA, CONGENITAL
TSPAN7	X连锁智力低下	MENTAL RETARDATION, X-LINKED 58
ARX	无脑回畸形	LISSENCEPHALY, X-LINKED, 2
HSD17B10	X连锁智力低下	MENTAL RETARDATION, X-LINKED, SYNDROMIC 10
DKC1	Hoyeraal-Hreidarsson综合征	HOYERAAL-HREIDARSSON SYNDROME
SLC9A6	X连锁智力低下	MENTAL RETARDATION, X-LINKED, SYNDROMIC, CHRISTIANSON TYPE
FLNA	骨发育不良	TERMINAL OSSEOUS DYSPLASIA
LAMP2	Danon病	DANON DISEASE
PHF8	X连锁智力低下	SIDERIUS X-LINKED MENTAL RETARDATION SYNDROME
IKBKG	少汗性外胚层发育不良	ECTODERMAL DYSPLASIA, HYPOHIDROTIC, WITH IMMUNE DEFICIENCY
WAS	中性粒细胞减少症	NEUTROPENIA, SEVERE CONGENITAL, X-LINKED
HPRT1	Lesch-Nyhan综合征	LESCH-NYHAN SYNDROME
HPRT1	痛风	KELLEY-SEEGMILLER SYNDROME
CUL4B	X连锁智力低下	MENTAL RETARDATION, X-LINKED, WITH SHORT STATURE, HYPOGONADISM, AND
GATA1	红细胞生成异常性贫血伴血小板减少症	THROMBOCYTOPENIA, X-LINKED, WITH OR WITHOUT DYSERYTHROPOIETIC ANEMIA
ACSL4	X连锁智力低下	MENTAL RETARDATION, X-LINKED 63
IL2RG	复合型免疫缺陷	SEVERE COMBINED IMMUNODEFICIENCY, X-LINKED
ARX	X连锁智力低下	MENTAL RETARDATION, X-LINKED, WITH OR WITHOUT SEIZURES, ARX-RELATED
CASK	FG综合征	FG SYNDROME 4
SHROOM4	X连锁智力低下	STOCCO DOS SANTOS X-LINKED MENTAL RETARDATION SYNDROME
ARHGEF6	X连锁智力低下	MENTAL RETARDATION, X-LINKED 46
HSD17B10	氧化还原酶缺乏症	17-@BETA-HYDROXYSTEROID DEHYDROGENASE X DEFICIENCY
ATRX	地中海贫血	ALPHA-THALASSEMIA MYELODYSPLASIA SYNDROME
RPGR	视网膜色素变性	RETINITIS PIGMENTOSA, X-LINKED, AND SINORESPIRATORY INFECTIONS, WITH
OPHN1	X连锁智力低下	MENTAL RETARDATION, X-LINKED, WITH CEREBELLAR HYPOPLASIA AND DISTINCTIVE
ATP7A	脊髓性肌萎缩症	SPINAL MUSCULAR ATROPHY, DISTAL, X-LINKED 3
SYN1	癫痫	EPILEPSY, X-LINKED, WITH VARIABLE LEARNING DISABILITIES AND BEHAVIOR
MECP2	自闭症	AUTISM, SUSCEPTIBILITY TO, X-LINKED 3
ZNF81	X连锁智力低下	MENTAL RETARDATION, X-LINKED 45
GPR143	白化病	ALBINISM, OCULAR, TYPE I
BMP15	卵巢发育不良	OVARIAN DYSGENESIS 2
SLC16A2	智力低下及肌萎缩综合征	ALLAN-HERNDON-DUDLEY SYNDROME
KDM5C	X连锁智力低下	MENTAL RETARDATION, X-LINKED, SYNDROMIC, CLAES-JENSEN TYPE
FLNA	脑室周围结节型异位	HETEROTOPIA, PERIVENTRICULAR, EHLERS-DANLOS VARIANT
AVPR2	抗利尿激素不适当综合征	NEPHROGENIC SYNDROME OF INAPPROPRIATE ANTIDIURESIS
PAK3	X连锁智力低下	MENTAL RETARDATION, X-LINKED 30
IKBKG	外胚层发育不全无汗症	IMMUNODEFICIENCY WITHOUT ANHIDROTIC ECTODERMAL DYSPLASIA
SMC1A	德朗热综合征	CORNELIA DE LANGE SYNDROME 2
POF1B	卵巢早衰	PREMATURE OVARIAN FAILURE 2B
ARHGEF9	癫痫	EPILEPTIC ENCEPHALOPATHY, EARLY INFANTILE, 8
MAOA	Brunner综合征	BRUNNER SYNDROME
C1GALT1C1	TN综合征	TN POLYAGGLUTINATION SYNDROME
FMR1	X染色体易脆症	FRAGILE X MENTAL RETARDATION SYNDROME
AP1S2	X连锁智力低下	MENTAL RETARDATION, X-LINKED 59
AR	尿道下裂	HYPOSPADIAS 1, X-LINKED
XIAP	淋巴细胞增生综合征	LYMPHOPROLIFERATIVE SYNDROME, X-LINKED, 2
IKBKG	免疫缺陷	IMMUNODEFICIENCY 33
IKBKG	侵袭性肺炎球菌病	INVASIVE PNEUMOCOCCAL DISEASE, RECURRENT ISOLATED, 2
SRPX2	运动性癫痫,智力低下和言语失用症	ROLANDIC EPILEPSY, MENTAL RETARDATION, AND SPEECH DYSPRAXIA, X-LINKED
PGK1	转移酶缺乏症	PHOSPHOGLYCERATE KINASE 1 DEFICIENCY
BRWD3	X连锁智力低下	MENTAL RETARDATION, X-LINKED 93
CDKL5	癫痫	EPILEPTIC ENCEPHALOPATHY, EARLY INFANTILE, 2
MECP2	新生儿重症脑病	ENCEPHALOPATHY, NEONATAL SEVERE, DUE TO MECP2 MUTATIONS
UPF3B	X连锁智力低下	MENTAL RETARDATION, X-LINKED, SYNDROMIC 14
FHL1	X-连锁肌病	SCAPULOPERONEAL MYOPATHY, X-LINKED DOMINANT
FHL1	肌病	MYOPATHY, X-LINKED, WITH POSTURAL MUSCLE ATROPHY
GRIA3	X连锁智力低下	MENTAL RETARDATION, X-LINKED, SYNDROMIC, WU TYPE
HUWE1	X连锁智力低下	MENTAL RETARDATION, X-LINKED, SYNDROMIC, TURNER TYPE
FAM58A	Star综合征	TOE SYNDACTYLY, TELECANTHUS, AND ANOGENITAL AND RENAL MALFORMATIONS
MAGT1	X连锁智力低下	MENTAL RETARDATION, X-LINKED 95
FHL1	X连锁还原体肌病	MYOPATHY, REDUCING BODY, X-LINKED, EARLY-ONSET, SEVERE
FHL1	X连锁还原体肌病	MYOPATHY, REDUCING BODY, X-LINKED, CHILDHOOD-ONSET
CASK	小头畸形	MENTAL RETARDATION AND MICROCEPHALY WITH PONTINE AND CEREBELLAR HYPOPLASIA
ALAS2	铁粒幼细胞贫血	ANEMIA, SIDEROBLASTIC, X-LINKED
BTK	无丙种球蛋白血症	AGAMMAGLOBULINEMIA, X-LINKED
MAMLD1	尿道下裂	HYPOSPADIAS 2, X-LINKED
CSF2RA	肺表面活性物质代谢功能障碍	SURFACTANT METABOLISM DYSFUNCTION, PULMONARY, 4
ZDHHC9	X连锁智力低下	MENTAL RETARDATION, X-LINKED, SYNDROMIC, RAYMOND TYPE
OFD1	朱伯特综合征	JOUBERT SYNDROME 10
WAS	维-奥二氏综合征	WISKOTT-ALDRICH SYNDROME
ATRX	X-连锁非缺失型α-地中海贫血/精神发育迟滞综合征	ALPHA-THALASSEMIA/MENTAL RETARDATION SYNDROME, X-LINKED
COL4A5	ALPORT综合征	ALPORT SYNDROME, X-LINKED
AMELX	牙釉质发育不全	AMELOGENESIS IMPERFECTA, TYPE IE
ABCB7	铁粒幼细胞贫血	ANEMIA, SIDEROBLASTIC, AND SPINOCEREBELLAR ATAXIA
GLA	法布瑞氏症	FABRY DISEASE
UBA1	脊髓性肌萎缩症	SPINAL MUSCULAR ATROPHY, X-LINKED 2
PRPS1	ARTS综合征	ARTS SYNDROME
PHF6	伯-福-莱三氏综合征	BORJESON-FORSSMAN-LEHMANN SYNDROME
DMD	扩张型心肌病	CARDIOMYOPATHY, DILATED, 3B
NHS	南切-霍兰综合症	NANCE-HORAN SYNDROME
GJB1	腓骨肌萎缩症	CHARCOT-MARIE-TOOTH DISEASE, X-LINKED DOMINANT, 1
ARSE	点状软骨发育不全	CHONDRODYSPLASIA PUNCTATA 1, X-LINKED RECESSIVE
EBP	点状软骨发育不全	CHONDRODYSPLASIA PUNCTATA 2, X-LINKED DOMINANT
CHM	无脉络膜症	CHOROIDEREMIA
L1CAM	MASA综合征	MASA SYNDROME
TBX22	腭裂	CLEFT PALATE WITH OR WITHOUT ANKYLOGLOSSIA, X-LINKED
RPS6KA3	COFFIN-LOWRY综合征	COFFIN-LOWRY SYNDROME
OPN1LW	全色盲	BLUE CONE MONOCHROMACY
OPN1MW	部分色盲	COLORBLINDNESS, PARTIAL, DEUTAN SERIES
L1CAM	部分胼胝体发育不全	CORPUS CALLOSUM, PARTIAL AGENESIS OF, X-LINKED
EFNB1	Craniofrontonasal综合症	CRANIOFRONTONASAL SYNDROME
FLNA	耳腭指综合征	OTOPALATODIGITAL SYNDROME, TYPE II
ATP7A	枕骨洞角综合征	OCCIPITAL HORN SYNDROME
POU3F4	先天性耳聋	DEAFNESS, X-LINKED 2
PRPS1	先天性耳聋	DEAFNESS, X-LINKED 1
TIMM8A	Mohr-Tranebjaerg综合征	MOHR-TRANEBJAERG SYNDROME
FOXP3	X连锁免疫失调	IMMUNODYSREGULATION, POLYENDOCRINOPATHY, AND ENTEROPATHY, X-LINKED
AVPR2	尿崩症	DIABETES INSIPIDUS, NEPHROGENIC, X-LINKED
DKC1	先天性角化不良	DYSKERATOSIS CONGENITA, X-LINKED
EDA	外胚层发育不良	ECTODERMAL DYSPLASIA 1, HYPOHIDROTIC, X-LINKED
NDP	渗出性玻璃体视网膜病	EXUDATIVE VITREORETINOPATHY 2, X-LINKED
FGD1	脸生殖器发育不良	AARSKOG-SCOTT SYNDROME
MED12	OPITZ-KAVEGGIA综合征	OPITZ-KAVEGGIA SYNDROME
PORCN	局灶性真皮发育不全综合征	FOCAL DERMAL HYPOPLASIA
FLNA	额骨干骺端结构不良	FRONTOMETAPHYSEAL DYSPLASIA
PHKA2	糖原贮积症	GLYCOGEN STORAGE DISEASE IXa1
CYBB	慢性肉芽肿病	GRANULOMATOUS DISEASE, CHRONIC, X-LINKED
ZIC3	内脏异位	HETEROTAXY, VISCERAL, 1, X-LINKED
L1CAM	先天性狭窄性脑积水	HYDROCEPHALUS DUE TO CONGENITAL STENOSIS OF AQUEDUCT OF SYLVIUS
PHEX	低磷酸盐血症性佝偻病	HYPOPHOSPHATEMIC RICKETS, X-LINKED DOMINANT
NSDHL	CHILD综合征	CONGENITAL HEMIDYSPLASIA WITH ICHTHYOSIFORM ERYTHRODERMA AND LIMB
STS	鱼鳞病	ICHTHYOSIS, X-LINKED
MBTPS2	鱼鳞病	IFAP SYNDROME WITH OR WITHOUT BRESHECK SYNDROME
CD40LG	免疫缺陷伴高IgM	IMMUNODEFICIENCY WITH HYPER-IgM, TYPE 1
SH2D1A	淋巴细胞增生综合征	LYMPHOPROLIFERATIVE SYNDROME, X-LINKED, 1
ARX	癫痫	EPILEPTIC ENCEPHALOPATHY, EARLY INFANTILE, 1
MBTPS2	秃发性小棘毛囊角化病	KERATOSIS FOLLICULARIS SPINULOSA DECALVANS, X-LINKED
PDHA1	Leigh 综合征	LEIGH SYNDROME, X-LINKED
CLCN5	低分子蛋白尿合并高钙尿症,肾钙质沉着症	PROTEINURIA, LOW MOLECULAR WEIGHT, WITH HYPERCALCIURIA AND NEPHROCALCINOSIS
OCRL	LOWE氏前脑硬化综合征	LOWE OCULOCEREBRORENAL SYNDROME
FLNA	Melnick-Needles综合征	MELNICK-NEEDLES SYNDROME
ATP7A	MENKES病	MENKES DISEASE
PQBP1	Renpenning综合征	RENPENNING SYNDROME 1
MED12	Lujan-Fryns综合症	LUJAN-FRYNS SYNDROME
IQSEC2	X连锁智力低下	MENTAL RETARDATION, X-LINKED 1
FTSJ1	X连锁智力低下	MENTAL RETARDATION, X-LINKED 9
ATRX	X连锁智力低下	MENTAL RETARDATION-HYPOTONIC FACIES SYNDROME, X-LINKED, 1
SMS	X连锁智力低下	MENTAL RETARDATION, X-LINKED, SYNDROMIC, SNYDER-ROBINSON TYPE
HCCS	小眼畸形综合征	MICROPHTHALMIA, SYNDROMIC 7
EMD	埃-德二氏肌营养不良	EMERY-DREIFUSS MUSCULAR DYSTROPHY 1, X-LINKED
MTM1	中央核性肌病	MYOPATHY, CENTRONUCLEAR, X-LINKED
NYX	先天性静止性夜盲症	NIGHT BLINDNESS, CONGENITAL STATIONARY, TYPE 1A
NDP	Norrie病	NORRIE DISEASE
FRMD7	先天性眼球震颤	NYSTAGMUS 1, CONGENITAL, X-LINKED
PRPS1	腓骨肌萎缩症	CHARCOT-MARIE-TOOTH DISEASE, X-LINKED RECESSIVE, 5
TIMM8A	延森氏综合征	OPTICOACOUSTIC NERVE ATROPHY WITH DEMENTIA
RBM10	TARP综合征	TARP SYNDROME
CFP	备解素缺乏症	PROPERDIN DEFICIENCY, X-LINKED
PLP1	脑白质营养不良	PELIZAEUS-MERZBACHER DISEASE
AR	雄激素不敏感综合征	ANDROGEN INSENSITIVITY, PARTIAL
RP2	视网膜色素变性	RETINITIS PIGMENTOSA 2
MECP2	Rett综合征	RETT SYNDROME
FOXG1	Rett综合征	RETT SYNDROME
IL2RG	复合型免疫缺陷	COMBINED IMMUNODEFICIENCY, X-LINKED
EDA	选择性牙齿发育不全	TOOTH AGENESIS, SELECTIVE, X-LINKED, 1
GATA1	血小板减少症	THROMBOCYTOPENIA WITH BETA-THALASSEMIA, X-LINKED
CYTB	婴儿心肌病	CARDIOMYOPATHY, INFANTILE HISTIOCYTOID
ND6	Leber遗传性视神经病变	LEBER OPTIC ATROPHY AND DYSTONIA
ND1	Leber遗传性视神经病变	LEBER OPTIC ATROPHY AND DYSTONIA
PTH1R	EIKEN综合征	EIKEN SYNDROME
PRPF8	视网膜色素变性	RETINITIS PIGMENTOSA 13
MYO7A	先天性耳聋	DEAFNESS, AUTOSOMAL RECESSIVE 2
CRB1	视网膜色素变性	RETINITIS PIGMENTOSA 12
ELOVL4	黄色斑点状眼底	STARGARDT DISEASE 3
PARK2	遗传性帕金森病	PARKINSON DISEASE 2, AUTOSOMAL RECESSIVE JUVENILE
RAB3GAP1	脑积水,无脑回和视网膜发育不全综合征	WARBURG MICRO SYNDROME 1
AGPS	软骨发育不全	RHIZOMELIC CHONDRODYSPLASIA PUNCTATA, TYPE 3
TULP1	视网膜色素变性	RETINITIS PIGMENTOSA 14
PRPF31	视网膜色素变性	RETINITIS PIGMENTOSA 11
HTRA1	脑白质病	CEREBRAL ARTERIOPATHY, AUTOSOMAL RECESSIVE, WITH SUBCORTICAL INFARCTS
CLN8	神经元蜡样质脂褐质沉积症	CEROID LIPOFUSCINOSIS, NEURONAL, 8
VANGL1	骶神经缺损与上脊膜膨出	SACRAL DEFECT WITH ANTERIOR MENINGOCELE
EDNRB	先天性巨结肠	HIRSCHSPRUNG DISEASE, SUSCEPTIBILITY TO, 2
TRPV4	脊髓性肌萎缩症	SPINAL MUSCULAR ATROPHY, DISTAL, CONGENITAL NONPROGRESSIVE
TEK	多重皮肤和粘膜静脉畸形	VENOUS MALFORMATIONS, MULTIPLE CUTANEOUS AND MUCOSAL
MYH9	巨血小板减少症和渐进神经性耳聋	MACROTHROMBOCYTOPENIA AND PROGRESSIVE SENSORINEURAL DEAFNESS
SPTBN2	脊髓小脑性共济失调	SPINOCEREBELLAR ATAXIA 5
GJA1	房室隔缺损	ATRIOVENTRICULAR SEPTAL DEFECT 3
MYO15A	先天性耳聋	DEAFNESS, AUTOSOMAL RECESSIVE 3
NIPA1	遗传性痉挛性截瘫	SPASTIC PARAPLEGIA 6, AUTOSOMAL DOMINANT
ACVRL1	遗传性出血性毛细血管扩张症	TELANGIECTASIA, HEREDITARY HEMORRHAGIC, TYPE 2
PUS1	肌病,乳酸性酸中毒和铁粒幼细胞性贫血	MYOPATHY, LACTIC ACIDOSIS, AND SIDEROBLASTIC ANEMIA 1
HNF1A	青年发病的成年型糖尿病	MATURITY-ONSET DIABETES OF THE YOUNG, TYPE 3
EDNRB	ABCD综合征	ABCD SYNDROME
LGI1	家族性颞叶癫痫	EPILEPSY, FAMILIAL TEMPORAL LOBE, 1
CHRNA4	癫痫	EPILEPSY, NOCTURNAL FRONTAL LOBE, 1
BMP4	先天性唇腭裂	OROFACIAL CLEFT 11
AIP	泌乳素分泌垂体腺瘤	PITUITARY ADENOMA, PROLACTIN-SECRETING
TUBB3	先天性眼外肌纤维化	FIBROSIS OF EXTRAOCULAR MUSCLES, CONGENITAL, 3A, WITH OR WITHOUT EXTRAOCULAR
CPT2	转移酶缺乏症	CARNITINE PALMITOYLTRANSFERASE II DEFICIENCY, INFANTILE
MYH14	先天性耳聋	DEAFNESS, AUTOSOMAL DOMINANT 4A
D2HGDH	戊二酸尿症	D-2-@HYDROXYGLUTARIC ACIDURIA 1
GNE	包涵体肌病	INCLUSION BODY MYOPATHY 2, AUTOSOMAL RECESSIVE
SLC26A4	先天性耳聋	DEAFNESS, AUTOSOMAL RECESSIVE 4, WITH ENLARGED VESTIBULAR AQUEDUCT
KCNJ10	先天性耳聋	DEAFNESS, AUTOSOMAL RECESSIVE 4, WITH ENLARGED VESTIBULAR AQUEDUCT
FOXI1	先天性耳聋	DEAFNESS, AUTOSOMAL RECESSIVE 4, WITH ENLARGED VESTIBULAR AQUEDUCT
CHMP2B	额颞痴呆	FRONTOTEMPORAL DEMENTIA, CHROMOSOME 3-LINKED
ABCB4	胆囊疾病	GALLBLADDER DISEASE 1
PRODH	精神分裂症	SCHIZOPHRENIA 4
CA4	视网膜色素变性	RETINITIS PIGMENTOSA 17
PRKAG2	家族性肥厚型心肌病	CARDIOMYOPATHY, FAMILIAL HYPERTROPHIC, 6
RAB7	腓骨肌萎缩症	CHARCOT-MARIE-TOOTH DISEASE, AXONAL, TYPE 2B
ANK2	心率失常	CARDIAC ARRHYTHMIA, ANKYRIN-B-RELATED
KRT1	掌跖角化病	PALMOPLANTAR KERATODERMA, NONEPIDERMOLYTIC
WFS1	先天性耳聋	DEAFNESS, AUTOSOMAL DOMINANT 6
COL9A3	多发性骨骺发育不良	EPIPHYSEAL DYSPLASIA, MULTIPLE, 3
TMIE	先天性耳聋	DEAFNESS, AUTOSOMAL RECESSIVE 6
SLC26A2	软骨发育不全	ACHONDROGENESIS, TYPE IB
TMC1	先天性耳聋	DEAFNESS, AUTOSOMAL RECESSIVE 7
PITPNM3	锥杆营养不良	CONE-ROD DYSTROPHY 5
DFNA5	先天性耳聋	DEAFNESS, AUTOSOMAL DOMINANT 5
NPHS2	肾病综合征	NEPHROTIC SYNDROME, TYPE 2
RYR2	致心律失常性右室心肌病	ARRHYTHMOGENIC RIGHT VENTRICULAR DYSPLASIA, FAMILIAL, 2
KRT14	单纯型大疱性表皮松解症	EPIDERMOLYSIS BULLOSA SIMPLEX, AUTOSOMAL RECESSIVE 1
ATP2A1	Brody肌病	BRODY MYOPATHY
CACNA1C	Timothy综合征	TIMOTHY SYNDROME
CDH23	尤塞氏综合症	USHER SYNDROME, TYPE ID
PCDH15	尤塞氏综合症	USHER SYNDROME, TYPE ID
OTOF	先天性耳聋	DEAFNESS, AUTOSOMAL RECESSIVE 9
TMPRSS3	先天性耳聋	DEAFNESS, AUTOSOMAL RECESSIVE 8
LITAF	腓骨肌萎缩症	CHARCOT-MARIE-TOOTH DISEASE, DEMYELINATING, TYPE 1C
ALG3	先天性糖基化障碍	CONGENITAL DISORDER OF GLYCOSYLATION, TYPE Id
SCN5A	Brugada综合征	BRUGADA SYNDROME 1
MFN2	神经病变	NEUROPATHY, HEREDITARY MOTOR AND SENSORY, TYPE VI
SCN5A	扩张型心肌病	CARDIOMYOPATHY, DILATED, 1E
STRA6	小眼畸形综合征	MICROPHTHALMIA, SYNDROMIC 9
DICER1	胸膜肺母细胞瘤	PLEUROPULMONARY BLASTOMA
ABCA12	鱼鳞病	ICHTHYOSIS, CONGENITAL, AUTOSOMAL RECESSIVE 4A
SGCD	肌营养不良	MUSCULAR DYSTROPHY, LIMB-GIRDLE, TYPE 2F
EYA4	先天性耳聋	DEAFNESS, AUTOSOMAL DOMINANT 10
MYO7A	先天性耳聋	DEAFNESS, AUTOSOMAL DOMINANT 11
RFX6	胰腺胆囊发育不良合并肠闭锁或食管气管瘘	PANCREATIC HYPOPLASIA, INTESTINAL ATRESIA, AND GALLBLADDER APLASIA OR HYPOPLASIA, WITH OR WITHOUT TRACHEOESOPHAGEAL FISTULA
COCH	先天性耳聋	DEAFNESS, AUTOSOMAL DOMINANT 9
ALDH18A1	皮肤松弛症	CUTIS LAXA, AUTOSOMAL RECESSIVE, TYPE IIIA
MTMR2	腓骨肌萎缩症	CHARCOT-MARIE-TOOTH DISEASE, TYPE 4B1
CDH23	先天性耳聋	DEAFNESS, AUTOSOMAL RECESSIVE 12
RUNX1	家族性血小板疾病合并联合髓系恶性血液病	PLATELET DISORDER, FAMILIAL, WITH ASSOCIATED MYELOID MALIGNANCY
ZFP57	新生儿暂时性糖尿病	DIABETES MELLITUS, TRANSIENT NEONATAL, 1
PRPF3	视网膜色素变性	RETINITIS PIGMENTOSA 18
DES	肌纤维肌病	MYOPATHY, MYOFIBRILLAR, 1
NDRG1	腓骨肌萎缩症	CHARCOT-MARIE-TOOTH DISEASE, TYPE 4D
RAG1	复合型免疫缺陷	SEVERE COMBINED IMMUNODEFICIENCY, AUTOSOMAL RECESSIVE, T CELL-NEGATIVE,
RAG2	复合型免疫缺陷	SEVERE COMBINED IMMUNODEFICIENCY, AUTOSOMAL RECESSIVE, T CELL-NEGATIVE,
CHRNB1	肌无力综合征	MYASTHENIC SYNDROME, CONGENITAL, SLOW-CHANNEL
CHRND	肌无力综合征	MYASTHENIC SYNDROME, CONGENITAL, SLOW-CHANNEL
CHRNE	肌无力综合征	MYASTHENIC SYNDROME, CONGENITAL, SLOW-CHANNEL
HYAL1	粘多糖贮积症	MUCOPOLYSACCHARIDOSIS, TYPE IX
TNNT2	扩张型心肌病	CARDIOMYOPATHY, DILATED, 1D
IGHM	无丙种球蛋白血症	AGAMMAGLOBULINEMIA 1, AUTOSOMAL RECESSIVE
RNASEL	前列腺癌	PROSTATE CANCER, HEREDITARY, 1
HOXA1	Athabaskan脑干发育不良综合征	ATHABASKAN BRAINSTEM DYSGENESIS SYNDROME
TECTA	先天性耳聋	DEAFNESS, AUTOSOMAL DOMINANT 12
CRYBB2	白内障	CATARACT 3, MULTIPLE TYPES
CDH3	黄斑营养不良	HYPOTRICHOSIS, CONGENITAL, WITH JUVENILE MACULAR DYSTROPHY
SH3TC2	腓骨肌萎缩症	CHARCOT-MARIE-TOOTH DISEASE, TYPE 4C
CYLD	多发性家族性毛发上皮瘤	TRICHOEPITHELIOMA, MULTIPLE FAMILIAL, 1
FOXC1	虹膜发育不全	IRIDOGONIODYSGENESIS, TYPE 1
SDHAF2	副神经节瘤	PARAGANGLIOMAS 2
ERCC3	毛发硫营养不良	TRICHOTHIODYSTROPHY, PHOTOSENSITIVE
TNNT3	远端关节弯曲	ARTHROGRYPOSIS, DISTAL, TYPE 2B
TNNI2	远端关节弯曲	ARTHROGRYPOSIS, DISTAL, TYPE 2B
FOXN1	T细胞免疫缺陷,先天性脱发和指甲营养不良综合征	T-CELL IMMUNODEFICIENCY, CONGENITAL ALOPECIA, AND NAIL DYSTROPHY
CHST14	Ehlers-Danlos综合征	EHLERS-DANLOS SYNDROME, MUSCULOCONTRACTURAL TYPE 1
GUCY2D	锥杆营养不良	CONE-ROD DYSTROPHY 6
CLN6	神经元蜡样质脂褐质沉积症	CEROID LIPOFUSCINOSIS, NEURONAL, 6
LRP5	渗出性玻璃体视网膜病	EXUDATIVE VITREORETINOPATHY 4
PHGDH	氧化还原酶缺乏症	PHOSPHOGLYCERATE DEHYDROGENASE DEFICIENCY
UGT1A1	血清胆红素水平数量性状位点1;BILIQTL1	BILIRUBIN, SERUM LEVEL OF, QUANTITATIVE TRAIT LOCUS 1
KCNJ11	高胰岛素低血糖症	HYPERINSULINEMIC HYPOGLYCEMIA, FAMILIAL, 2
ABCB11	进行性家族性肝内胆汁淤积症	CHOLESTASIS, PROGRESSIVE FAMILIAL INTRAHEPATIC, 2
COL11A2	先天性耳聋	DEAFNESS, AUTOSOMAL DOMINANT 13
LRP5	骨矿物质密度数量性状位点1;BMND1	BONE MINERAL DENSITY QUANTITATIVE TRAIT LOCUS 1
CACNA1S	恶性过热易感5	MALIGNANT HYPERTHERMIA, SUSCEPTIBILITY TO, 5
POMP	鱼鳞病	KERATOSIS LINEARIS WITH ICHTHYOSIS CONGENITA AND SCLEROSING KERATODERMA
TCAP	肌营养不良	MUSCULAR DYSTROPHY, LIMB-GIRDLE, TYPE 2G
TRPM6	低镁血症	HYPOMAGNESEMIA 1, INTESTINAL
KRT85	外胚层发育不良	ECTODERMAL DYSPLASIA 4, HAIR/NAIL TYPE
PHOX2A	先天性眼外肌纤维化	FIBROSIS OF EXTRAOCULAR MUSCLES, CONGENITAL, 2
FMO3	三甲基胺尿症	TRIMETHYLAMINURIA
FOXP2	语言障碍	SPEECH-LANGUAGE DISORDER 1
INVS	肾消耗病	NEPHRONOPHTHISIS 2
GUCA1A	视锥细胞营养不良	CONE DYSTROPHY 3
MMP13	脊椎干骺端发育不良	SPONDYLOEPIMETAPHYSEAL DYSPLASIA, MISSOURI TYPE
ABCB4	进行性家族性肝内胆汁淤积症	CHOLESTASIS, PROGRESSIVE FAMILIAL INTRAHEPATIC, 3
DHCR24	Desmosterolosis	DESMOSTEROLOSIS
SETX	肌萎缩侧索硬化	AMYOTROPHIC LATERAL SCLEROSIS 4, JUVENILE
DCLRE1C	复合型免疫缺陷	SEVERE COMBINED IMMUNODEFICIENCY WITH SENSITIVITY TO IONIZING RADIATION
POU4F3	先天性耳聋	DEAFNESS, AUTOSOMAL DOMINANT 15
ETHE1	乙基丙二酸性脑病	ENCEPHALOPATHY, ETHYLMALONIC
ATP1A2	偏瘫性偏头痛	MIGRAINE, FAMILIAL HEMIPLEGIC, 2
FOXC1	AXENFELD-RIEGER综合征	AXENFELD-RIEGER SYNDROME, TYPE 3
GCK	高胰岛素低血糖症	HYPERINSULINEMIC HYPOGLYCEMIA, FAMILIAL, 3
BSND	Bartter综合征	BARTTER SYNDROME, TYPE 4A
GJB2	鱼鳞病	ICHTHYOSIS, HYSTRIX-LIKE, WITH DEAFNESS
MPI	先天性糖基化障碍	CONGENITAL DISORDER OF GLYCOSYLATION, TYPE Ib
CRYGD	白内障	CATARACT 4, MULTIPLE TYPES
EYA1	鳃耳综合征	BRANCHIOOTIC SYNDROME 1
THAP1	肌张力障碍	DYSTONIA 6, TORSION
ATP6V0A4	肾小管酸中毒	RENAL TUBULAR ACIDOSIS, DISTAL, AUTOSOMAL RECESSIVE
EYS	视网膜色素变性	RETINITIS PIGMENTOSA 25
FGFR3	Muenke综合征	MUENKE SYNDROME
TYMP	线粒体DNA缺失综合征	MITOCHONDRIAL DNA DEPLETION SYNDROME 1 (MNGIE TYPE)
ALG6	先天性糖基化障碍	CONGENITAL DISORDER OF GLYCOSYLATION, TYPE Ic
TMEM216	Meckel综合征	MECKEL SYNDROME, TYPE 2
ACTN4	局灶性节段性肾小球硬化症	FOCAL SEGMENTAL GLOMERULOSCLEROSIS 1
BCS1L	GRACILE综合征	GRACILE SYNDROME
TSHR	家族性妊娠期甲状腺功能亢进症	HYPERTHYROIDISM, FAMILIAL GESTATIONAL
SLC25A13	瓜氨酸血症	CITRULLINEMIA, TYPE II, ADULT-ONSET
GAD1	痉挛性四肢瘫痪,脑性麻痹	CEREBRAL PALSY, SPASTIC QUADRIPLEGIC, 1
DDX11	脊髓小脑性共济失调	SPINOCEREBELLAR ATAXIA 10
TP63	肢体-乳腺综合征	LIMB-MAMMARY SYNDROME
STX11	噬血细胞性淋巴组织细胞增多症	HEMOPHAGOCYTIC LYMPHOHISTIOCYTOSIS, FAMILIAL, 4
PRF1	噬血细胞性淋巴组织细胞增多症	HEMOPHAGOCYTIC LYMPHOHISTIOCYTOSIS, FAMILIAL, 2
RAG1	OMENN综合征	OMENN SYNDROME
RAG2	OMENN综合征	OMENN SYNDROME
DCLRE1C	OMENN综合征	OMENN SYNDROME
KIAA0196	遗传性痉挛性截瘫	SPASTIC PARAPLEGIA 8, AUTOSOMAL DOMINANT
MYH9	先天性耳聋	DEAFNESS, AUTOSOMAL DOMINANT 17
TECTA	先天性耳聋	DEAFNESS, AUTOSOMAL RECESSIVE 21
RIMS1	锥杆营养不良	CONE-ROD DYSTROPHY 7
EPHB2	前列腺癌/脑肿瘤易感性	PROSTATE CANCER/BRAIN CANCER SUSCEPTIBILITY
TTN	遗传性肌病并早期呼吸衰竭	HEREDITARY MYOPATHY WITH EARLY RESPIRATORY FAILURE
PCSK9	高胆固醇血症	HYPERCHOLESTEROLEMIA, AUTOSOMAL DOMINANT, 3
LDLRAP1	高胆固醇血症	HYPERCHOLESTEROLEMIA, AUTOSOMAL RECESSIVE
SCN5A	家族性阵发性心室颤动	VENTRICULAR FIBRILLATION, PAROXYSMAL FAMILIAL, 1
SCN5A	长Q-T间期综合征	LONG QT SYNDROME 3
UMOD	肾髓质囊性病	MEDULLARY CYSTIC KIDNEY DISEASE 2
EIF2B1	脑白质病	LEUKOENCEPHALOPATHY WITH VANISHING WHITE MATTER
EIF2B2	脑白质病	LEUKOENCEPHALOPATHY WITH VANISHING WHITE MATTER
EIF2B3	脑白质病	LEUKOENCEPHALOPATHY WITH VANISHING WHITE MATTER
EIF2B4	脑白质病	LEUKOENCEPHALOPATHY WITH VANISHING WHITE MATTER
EIF2B5	脑白质病	LEUKOENCEPHALOPATHY WITH VANISHING WHITE MATTER
HBB	地中海贫血	BETA-THALASSEMIA, DOMINANT INCLUSION BODY TYPE
HBB	镰状细胞贫血	SICKLE CELL ANEMIA
CASP10	自身免疫性淋巴细胞增生综合征	AUTOIMMUNE LYMPHOPROLIFERATIVE SYNDROME, TYPE IIA
TRPC6	局灶性节段性肾小球硬化症	FOCAL SEGMENTAL GLOMERULOSCLEROSIS 2
MLC1	巨颅伴皮层下海绵样囊肿性脑白质病	MEGALENCEPHALIC LEUKOENCEPHALOPATHY WITH SUBCORTICAL CYSTS 1
CTDP1	先天性白内障,面部畸形和神经疾病综合征	CONGENITAL CATARACTS, FACIAL DYSMORPHISM, AND NEUROPATHY
DTNA	左室心肌致密化不全	LEFT VENTRICULAR NONCOMPACTION 1
KIF5A	遗传性痉挛性截瘫	SPASTIC PARAPLEGIA 10, AUTOSOMAL DOMINANT
SERPINI1	NSP包含体家族性脑病	ENCEPHALOPATHY, FAMILIAL, WITH NEUROSERPIN INCLUSION BODIES
PAX6	Peters异常	PETERS ANOMALY
PITX2	Peters异常	PETERS ANOMALY
CYP1B1	Peters异常	PETERS ANOMALY
FOXC1	Peters异常	PETERS ANOMALY
SPATA7	莱伯氏先天性黑矇	LEBER CONGENITAL AMAUROSIS 3
TFR2	血色素沉着症	HEMOCHROMATOSIS, TYPE 3
GHSR	特发性身材矮小	GROWTH HORMONE INSENSITIVITY, PARTIAL
ATPAF2	核编码的ATP酶缺失	MITOCHONDRIAL COMPLEX V (ATP SYNTHASE) DEFICIENCY, NUCLEAR TYPE 1
SLC4A4	肾小管酸中毒	RENAL TUBULAR ACIDOSIS, PROXIMAL, WITH OCULAR ABNORMALITIES AND MENTAL
CP	无铜蓝蛋白血症	ACERULOPLASMINEMIA
TP63	先天性缺指(趾)-外胚层发育不良-唇裂/腭裂综合征	ECTRODACTYLY, ECTODERMAL DYSPLASIA, AND CLEFT LIP/PALATE SYNDROME
CRYBB2	白内障	CATARACT 2, MULTIPLE TYPES
FBN1	MASS综合征	MASS SYNDROME
IGHMBP2	脊髓性肌萎缩症	SPINAL MUSCULAR ATROPHY, DISTAL, AUTOSOMAL RECESSIVE, 1
PER2	家族性睡眠状态提前综合征	ADVANCED SLEEP PHASE SYNDROME, FAMILIAL, 1
CSNK1D	家族性睡眠状态提前综合征	ADVANCED SLEEP PHASE SYNDROME, FAMILIAL, 1
GPR98	惊厥	FEBRILE SEIZURES, FAMILIAL, 4
PPARG	局部脂肪营养不良	LIPODYSTROPHY, FAMILIAL PARTIAL, TYPE 3
SLC17A5	唾液酸尿症	SALLA DISEASE
SCO2	氧化还原酶缺乏症	CARDIOENCEPHALOMYOPATHY, FATAL INFANTILE, DUE TO CYTOCHROME c OXIDASE
LIPH	少毛症	HYPOTRICHOSIS 7
NPHP3	肾消耗病	NEPHRONOPHTHISIS 3
TMEM43	致心律失常性右室心肌病	ARRHYTHMOGENIC RIGHT VENTRICULAR DYSPLASIA, FAMILIAL, 5
PSTPIP1	无菌化脓性关节炎,坏疽性脓皮病和痤疮	PYOGENIC STERILE ARTHRITIS, PYODERMA GANGRENOSUM, AND ACNE
PKP1	外胚层发育不良/皮肤脆性综合征	ECTODERMAL DYSPLASIA/SKIN FRAGILITY SYNDROME
LCA5	莱伯氏先天性黑矇	LEBER CONGENITAL AMAUROSIS 5
SBF2	腓骨肌萎缩症	CHARCOT-MARIE-TOOTH DISEASE, TYPE 4B2
PAX9	选择性牙齿发育不全	TOOTH AGENESIS, SELECTIVE, 3
SLC6A2	立位不耐受	ORTHOSTATIC INTOLERANCE
ACTG1	先天性耳聋	DEAFNESS, AUTOSOMAL DOMINANT 20
MSX2	颅缝早闭	CRANIOSYNOSTOSIS 2
DES	扩张型心肌病	CARDIOMYOPATHY, DILATED, 1I
RYR2	室性心动过速	VENTRICULAR TACHYCARDIA, CATECHOLAMINERGIC POLYMORPHIC, 1, WITH OR
CYP4F22	鱼鳞病	ICHTHYOSIS, CONGENITAL, AUTOSOMAL RECESSIVE 5
COL11A1	斯蒂克勒综合征	STICKLER SYNDROME, TYPE II
COL2A1	软骨骨关节炎	OSTEOARTHRITIS WITH MILD CHONDRODYSPLASIA
CIRH1A	北美印第安人儿童肝硬化	NORTH AMERICAN INDIAN CHILDHOOD CIRRHOSIS
CISD2	Wolfram综合征	WOLFRAM SYNDROME 2
RNR1	先天性耳聋	DEAFNESS, NONSYNDROMIC SENSORINEURAL, MITOCHONDRIAL
TBC1D24	癫痫	MYOCLONIC EPILEPSY, FAMILIAL INFANTILE
BRAF	非霍奇金淋巴瘤	LYMPHOMA, NON-HODGKIN, FAMILIAL
PRF1	非霍奇金淋巴瘤	LYMPHOMA, NON-HODGKIN, FAMILIAL
ASXL1	Bohring-Opitz综合征	BOHRING-OPITZ SYNDROME
CYLD	Brooke-Spiegler综合征	BROOKE-SPIEGLER SYNDROME
NR3C2	早发性高血压伴怀孕时严重恶化	HYPERTENSION, EARLY-ONSET, AUTOSOMAL DOMINANT, WITH SEVERE EXACERBATION
MYH9	Sebastian综合征	SEBASTIAN SYNDROME
EGR2	先天性低髓鞘形成性神经病	NEUROPATHY, CONGENITAL HYPOMYELINATING OR AMYELINATING, AUTOSOMAL
MPZ	先天性低髓鞘形成性神经病	NEUROPATHY, CONGENITAL HYPOMYELINATING OR AMYELINATING, AUTOSOMAL
AICDA	免疫缺陷伴高IgM	IMMUNODEFICIENCY WITH HYPER-IgM, TYPE 2
KCNC3	脊髓小脑性共济失调	SPINOCEREBELLAR ATAXIA 13
HSPD1	遗传性痉挛性截瘫	SPASTIC PARAPLEGIA 13, AUTOSOMAL DOMINANT
TP63	手裂/足裂畸形	SPLIT-HAND/FOOT MALFORMATION 4
PTEN	大头畸形综合征	MACROCEPHALY/AUTISM SYNDROME
TNNT1	线状体肌病	NEMALINE MYOPATHY 5
PRKCG	脊髓小脑性共济失调	SPINOCEREBELLAR ATAXIA 14
CHRNB2	癫痫	EPILEPSY, NOCTURNAL FRONTAL LOBE, 3
CFC1	内脏异位	HETEROTAXY, VISCERAL, 2, AUTOSOMAL
CHMP4B	白内障	CATARACT 31, MULTIPLE TYPES
TH	Segawa综合征	SEGAWA SYNDROME, AUTOSOMAL RECESSIVE
GPR98	尤塞氏综合症	USHER SYNDROME, TYPE IIC
ABCB11	良性复发性肝内胆汁淤积	CHOLESTASIS, BENIGN RECURRENT INTRAHEPATIC, 2
SLC17A8	先天性耳聋	DEAFNESS, AUTOSOMAL DOMINANT 25
LMNA	腓骨肌萎缩症	CHARCOT-MARIE-TOOTH DISEASE, AXONAL, TYPE 2B1
MED25	腓骨肌萎缩症	CHARCOT-MARIE-TOOTH DISEASE, AXONAL, TYPE 2B2
DSPP	先天性耳聋	DEAFNESS, AUTOSOMAL DOMINANT 39, WITH DENTINOGENESIS IMPERFECTA 1
MYH2	包涵体肌病	INCLUSION BODY MYOPATHY 3, AUTOSOMAL DOMINANT
C1QTNF5	视网膜变性	LATE-ONSET RETINAL DEGENERATION
DSP	扩张型心肌病	CARDIOMYOPATHY, DILATED, WITH WOOLLY HAIR AND KERATODERMA
APP	脑淀粉样血管病	CEREBRAL AMYLOID ANGIOPATHY, APP-RELATED
BRCA2	范可尼贫血	FANCONI ANEMIA, COMPLEMENTATION GROUP D1
FLG	特应性皮炎2	DERMATITIS, ATOPIC, 2
SLC25A13	瓜氨酸血症	CITRULLINEMIA, TYPE II, NEONATAL-ONSET
GNE	Nonaka肌病	NONAKA MYOPATHY
DMGDH	氧化还原酶缺乏症	DIMETHYLGLYCINE DEHYDROGENASE DEFICIENCY
GLDC	甘氨酸脑病	GLYCINE ENCEPHALOPATHY
AMT	甘氨酸脑病	GLYCINE ENCEPHALOPATHY
PINK1	遗传性帕金森病	PARKINSON DISEASE 6, AUTOSOMAL RECESSIVE EARLY-ONSET
HMGCS2	合成酶缺乏症	3-@HYDROXY-3-METHYLGLUTARYL-CoA SYNTHASE 2 DEFICIENCY
SETX	脊髓小脑性共济失调	SPINOCEREBELLAR ATAXIA, AUTOSOMAL RECESSIVE 1
PCCA	合成酶缺乏症	PROPIONIC ACIDEMIA
PCCB	合成酶缺乏症	PROPIONIC ACIDEMIA
MOGS	先天性糖基化障碍	CONGENITAL DISORDER OF GLYCOSYLATION, TYPE IIb
FAM161A	视网膜色素变性	RETINITIS PIGMENTOSA 28
SLC40A1	血色素沉着症	HEMOCHROMATOSIS, TYPE 4
MATR3	肌萎缩侧索硬化	AMYOTROPHIC LATERAL SCLEROSIS 21
TRPV4	腓骨肌萎缩症	HEREDITARY MOTOR AND SENSORY NEUROPATHY, TYPE IIC
CAV3	波纹肌肉病	RIPPLING MUSCLE DISEASE
FTL	大脑铁沉积性神经退行性变	NEURODEGENERATION WITH BRAIN IRON ACCUMULATION 3
GCK	永久性新生儿糖尿病	DIABETES MELLITUS, PERMANENT NEONATAL
KCNJ11	永久性新生儿糖尿病	DIABETES MELLITUS, PERMANENT NEONATAL
INS	永久性新生儿糖尿病	DIABETES MELLITUS, PERMANENT NEONATAL
ABCC8	永久性新生儿糖尿病	DIABETES MELLITUS, PERMANENT NEONATAL
PARK7	遗传性帕金森病	PARKINSON DISEASE 7, AUTOSOMAL RECESSIVE EARLY-ONSET
MYO6	先天性耳聋	DEAFNESS, AUTOSOMAL DOMINANT 22
DNM2	腓骨肌萎缩症	CHARCOT-MARIE-TOOTH DISEASE, DOMINANT INTERMEDIATE B
LIG4	连接酶4综合征	LIG4 SYNDROME
HSPB1	腓骨肌萎缩症	CHARCOT-MARIE-TOOTH DISEASE, AXONAL, TYPE 2F
FKRP	肌营养不良-抗肌萎缩相关糖蛋白病	MUSCULAR DYSTROPHY-DYSTROGLYCANOPATHY (CONGENITAL WITH OR WITHOUT
OPTN	正常眼压性青光眼,易感性	GLAUCOMA, NORMAL TENSION, SUSCEPTIBILITY TO
GNMT	转移酶缺乏症	GLYCINE N-METHYLTRANSFERASE DEFICIENCY
SGCD	扩张型心肌病	CARDIOMYOPATHY, DILATED, 1L
PRNP	海绵状脑病伴神经精神病特征	SPONGIFORM ENCEPHALOPATHY WITH NEUROPSYCHIATRIC FEATURES
TSC1	淋巴管平滑肌增多症	LYMPHANGIOLEIOMYOMATOSIS
TSC2	淋巴管平滑肌增多症	LYMPHANGIOLEIOMYOMATOSIS
ATP13A2	Kufor-Rakeb综合征	KUFOR-RAKEB SYNDROME
TMC1	先天性耳聋	DEAFNESS, AUTOSOMAL DOMINANT 36
CDKN2A	黑色素瘤-胰腺癌综合征	MELANOMA-PANCREATIC CANCER SYNDROME
GLUD1	高胰岛素低血糖症	HYPERINSULINEMIC HYPOGLYCEMIA, FAMILIAL, 6
KIT	胃肠道间质瘤	GASTROINTESTINAL STROMAL TUMOR
PDGFRA	胃肠道间质瘤	GASTROINTESTINAL STROMAL TUMOR
SDHB	胃肠道间质瘤	GASTROINTESTINAL STROMAL TUMOR
SDHC	胃肠道间质瘤	GASTROINTESTINAL STROMAL TUMOR
SLC2A1	葡萄糖转运蛋白1缺陷综合征	GLUT1 DEFICIENCY SYNDROME 1
UGT1A1	Crigler-Najjar综合征	CRIGLER-NAJJAR SYNDROME, TYPE II
FH	延胡索酸酶缺乏症	FUMARASE DEFICIENCY
SLC5A1	葡葡糖/半乳糖吸收不良	GLUCOSE/GALACTOSE MALABSORPTION
CD40	免疫缺陷伴高IgM	IMMUNODEFICIENCY WITH HYPER-IgM, TYPE 3
GPR56	多小脑回畸形	POLYMICROGYRIA, BILATERAL FRONTOPARIETAL
SDHB	副神经节瘤和胃间质肉瘤	PARAGANGLIOMA AND GASTRIC STROMAL SARCOMA
SDHC	副神经节瘤和胃间质肉瘤	PARAGANGLIOMA AND GASTRIC STROMAL SARCOMA
SDHD	副神经节瘤和胃间质肉瘤	PARAGANGLIOMA AND GASTRIC STROMAL SARCOMA
PSEN2	阿尔茨海默病	ALZHEIMER DISEASE 4
USH1G	尤塞氏综合症	USHER SYNDROME, TYPE IG
TYR	白化病	ALBINISM, OCULOCUTANEOUS, TYPE IB
NPHP4	肾消耗病	NEPHRONOPHTHISIS 4
NPHP4	senior-loken综合征	SENIOR-LOKEN SYNDROME 4
IDUA	Hurler综合征	HURLER SYNDROME
IDUA	Hurler-Scheie综合征	HURLER-SCHEIE SYNDROME
IDUA	粘多糖贮积症	SCHEIE SYNDROME
OTOA	先天性耳聋	DEAFNESS, AUTOSOMAL RECESSIVE 22
LRRK2	遗传性帕金森病	PARKINSON DISEASE 8, AUTOSOMAL DOMINANT
MATN3	多发性骨骺发育不良	EPIPHYSEAL DYSPLASIA, MULTIPLE, 5
DHH	46,性反转	46,XY GONADAL DYSGENESIS, PARTIAL, WITH MINIFASCICULAR NEUROPATHY
DFNB31	先天性耳聋	DEAFNESS, AUTOSOMAL RECESSIVE 31
RMRP	ANAUXETIC发育不良	ANAUXETIC DYSPLASIA
MYO3A	先天性耳聋	DEAFNESS, AUTOSOMAL RECESSIVE 30
NLRP3	Cinca综合征	CINCA SYNDROME
EPHA2	白内障	CATARACT 6, MULTIPLE TYPES
ALG12	先天性糖基化障碍	CONGENITAL DISORDER OF GLYCOSYLATION, TYPE Ig
FKRP	肌营养不良-抗肌萎缩相关糖蛋白病	MUSCULAR DYSTROPHY-DYSTROGLYCANOPATHY (LIMB-GIRDLE), TYPE C, 5
NF2	脑膜瘤	MENINGIOMA, FAMILIAL, SUSCEPTIBILITY TO
SLC25A19	小头畸形	MICROCEPHALY, AMISH TYPE
DUOX2	甲状腺激素生成障碍	THYROID DYSHORMONOGENESIS 6
SCN1A	癫痫	EPILEPTIC ENCEPHALOPATHY, EARLY INFANTILE, 6
ALS2	婴幼儿发病升序遗传性痉挛性瘫痪	SPASTIC PARALYSIS, INFANTILE-ONSET ASCENDING
PANK2	HARP综合征	HYPOPREBETALIPOPROTEINEMIA, ACANTHOCYTOSIS, RETINITIS PIGMENTOSA,
SPG7	遗传性痉挛性截瘫	SPASTIC PARAPLEGIA 7, AUTOSOMAL RECESSIVE
CASP8	水解酶缺乏症	CASPASE 8 DEFICIENCY
ADRB1	静息心率	RESTING HEART RATE, VARIATION IN
ROBO3	家族性水平注视麻痹伴进行性脊柱侧凸	GAZE PALSY, FAMILIAL HORIZONTAL, WITH PROGRESSIVE SCOLIOSIS
SALL4	杜安-桡侧列综合征	DUANE-RADIAL RAY SYNDROME
DYM	Smith-McCort发育不良	SMITH-MCCORT DYSPLASIA 1
SC5DL	Lathosterolosis	LATHOSTEROLOSIS
TSC1	Taylor局灶性皮质发育不良	FOCAL CORTICAL DYSPLASIA OF TAYLOR
CLCNKB	Bartter综合征	BARTTER SYNDROME, TYPE 3
ACTB	肌张力障碍	DYSTONIA, JUVENILE-ONSET
MRAP	糖皮质激素缺乏症	GLUCOCORTICOID DEFICIENCY 2
CRBN	智力低下	MENTAL RETARDATION, AUTOSOMAL RECESSIVE 2
ADCK3	辅酶Q10缺陷症	COENZYME Q10 DEFICIENCY, PRIMARY, 1
COQ2	辅酶Q10缺陷症	COENZYME Q10 DEFICIENCY, PRIMARY, 1
PDSS2	辅酶Q10缺陷症	COENZYME Q10 DEFICIENCY, PRIMARY, 1
APTX	辅酶Q10缺陷症	COENZYME Q10 DEFICIENCY, PRIMARY, 1
PDSS1	辅酶Q10缺陷症	COENZYME Q10 DEFICIENCY, PRIMARY, 1
COQ9	辅酶Q10缺陷症	COENZYME Q10 DEFICIENCY, PRIMARY, 1
PAFAH1B1	无脑回畸形	LISSENCEPHALY 1
DSP	致心律失常性右室心肌病	ARRHYTHMOGENIC RIGHT VENTRICULAR DYSPLASIA, FAMILIAL, 8
POLG	感觉性共济失调性周围神经病伴构音障碍及眼肌麻痹	SENSORY ATAXIC NEUROPATHY, DYSARTHRIA, AND OPHTHALMOPARESIS
NDUFA13	甲状腺癌	THYROID CARCINOMA, HURTHLE CELL
VKORC1	维生素K依赖性联合凝血因子缺乏症	VITAMIN K-DEPENDENT CLOTTING FACTORS, COMBINED DEFICIENCY OF, 2
RLBP1	视网膜营养不良	BOTHNIA RETINAL DYSTROPHY
RLBP1	纽芬兰视杆视锥营养不良	NEWFOUNDLAND ROD-CONE DYSTROPHY
CSRP3	扩张型心肌病	CARDIOMYOPATHY, DILATED, 1M
SLC19A3	硫胺素代谢障碍综合征	THIAMINE METABOLISM DYSFUNCTION SYNDROME 2 (BIOTIN- OR THIAMINE-RESPONSIVE
GRN	GRN相关的额颞叶变性	FRONTOTEMPORAL LOBAR DEGENERATION WITH TDP43 INCLUSIONS, GRN-RELATED
TCAP	扩张型心肌病	CARDIOMYOPATHY, DILATED, 1N
COL7A1	非综合征性先天性指甲障碍	NAIL DISORDER, NONSYNDROMIC CONGENITAL, 8
TGFBI	角膜营养不良	CORNEAL DYSTROPHY, AVELLINO TYPE
KCNQ1	心房颤动	ATRIAL FIBRILLATION, FAMILIAL, 3
COL4A1	脑小血管病伴出血	BRAIN SMALL VESSEL DISEASE WITH OR WITHOUT OCULAR ANOMALIES
VRK1	脑桥小脑发育不全	PONTOCEREBELLAR HYPOPLASIA, TYPE 1A
ERBB3	先天致死性挛缩综合征	LETHAL CONGENITAL CONTRACTURE SYNDROME 2
KRT1	鱼鳞病	ICHTHYOSIS, CYCLIC, WITH EPIDERMOLYTIC HYPERKERATOSIS
RAB27A	格里塞利综合征	GRISCELLI SYNDROME, TYPE 2
NPC2	尼曼-皮克病(鞘磷脂沉积病)	NIEMANN-PICK DISEASE, TYPE C2
LRP5	骨硬化病	OSTEOPETROSIS, AUTOSOMAL DOMINANT 1
LRP5	vanBuchem病	VAN BUCHEM DISEASE, TYPE 2
DCTN1	远端遗传性运动神经元病	NEURONOPATHY, DISTAL HEREDITARY MOTOR, TYPE VIIB
KRT1	角化症掌跖病纹状体	KERATOSIS PALMOPLANTARIS STRIATA III
DSP	皮脆性卷曲毛发综合征	SKIN FRAGILITY-WOOLLY HAIR SYNDROME
IRAK4	转移酶缺乏症	IRAK4 DEFICIENCY
MPZ	腓骨肌萎缩症	CHARCOT-MARIE-TOOTH DISEASE, AXONAL, TYPE 2I
EGR2	腓骨肌萎缩症	CHARCOT-MARIE-TOOTH DISEASE, DEMYELINATING, TYPE 1D
GABRG2	儿童失神性癫痫	EPILEPSY, CHILDHOOD ABSENCE, SUSCEPTIBILITY TO, 2
CACNB4	特发性全身性癫痫	EPILEPSY, IDIOPATHIC GENERALIZED, SUSCEPTIBILITY TO, 9
NEFL	腓骨肌萎缩症	CHARCOT-MARIE-TOOTH DISEASE, AXONAL, TYPE 2E
PDGFRA	特发性高嗜酸性粒细胞综合征	HYPEREOSINOPHILIC SYNDROME, IDIOPATHIC
GIGYF2	遗传性帕金森病	PARKINSON DISEASE 11, AUTOSOMAL DOMINANT
GDAP1	腓骨肌萎缩症	CHARCOT-MARIE-TOOTH DISEASE, AXONAL, WITH VOCAL CORD PARESIS, AUTOSOMAL
SHOC2	努南综合征	NOONAN SYNDROME-LIKE DISORDER WITH LOOSE ANAGEN HAIR
MPZ	腓骨肌萎缩症	CHARCOT-MARIE-TOOTH DISEASE, AXONAL, TYPE 2J
SCN2A	癫痫	SEIZURES, BENIGN FAMILIAL INFANTILE, 3
TJP2	家族性高胆烷血症	HYPERCHOLANEMIA, FAMILIAL
BAAT	家族性高胆烷血症	HYPERCHOLANEMIA, FAMILIAL
HSD3B7	先天性胆汁酸合成缺陷	BILE ACID SYNTHESIS DEFECT, CONGENITAL, 1
IHH	股骨头发育不良	ACROCAPITOFEMORAL DYSPLASIA
MPZ	腓骨肌萎缩症	CHARCOT-MARIE-TOOTH DISEASE, DOMINANT INTERMEDIATE D
SEC23A	颅额鼻发育不良	CRANIOLENTICULOSUTURAL DYSPLASIA
MYO6	先天性耳聋	DEAFNESS, AUTOSOMAL RECESSIVE 37
PSEN1	阿尔茨海默病	ALZHEIMER DISEASE 3
SOX18	少毛症	HYPOTRICHOSIS-LYMPHEDEMA-TELANGIECTASIA SYNDROME
GDAP1	腓骨肌萎缩症	CHARCOT-MARIE-TOOTH DISEASE, AXONAL, TYPE 2K
MYO1A	先天性耳聋	DEAFNESS, AUTOSOMAL DOMINANT 48
GFI1	中性粒细胞减少症	NEUTROPENIA, NONIMMUNE CHRONIC IDIOPATHIC, OF ADULTS
DSG4	少毛症	HYPOTRICHOSIS 6
ALG2	先天性糖基化障碍	CONGENITAL DISORDER OF GLYCOSYLATION, TYPE Ii
BMP4	小眼畸形综合征	MICROPHTHALMIA, SYNDROMIC 6
GATA4	房间隔缺损	ATRIAL SEPTAL DEFECT 2
GBA	戈谢病	GAUCHER DISEASE, PERINATAL LETHAL
FUS	肌萎缩侧索硬化	AMYOTROPHIC LATERAL SCLEROSIS 6, WITH OR WITHOUT FRONTOTEMPORAL DEMENTIA
PROM1	黄斑营养不良	MACULAR DYSTROPHY, RETINAL, 2
DPAGT1	先天性糖基化障碍	CONGENITAL DISORDER OF GLYCOSYLATION, TYPE Ij
ARFGEF2	脑室周围结节型异位	PERIVENTRICULAR HETEROTOPIA WITH MICROCEPHALY, AUTOSOMAL RECESSIVE
SGCA	肌营养不良	MUSCULAR DYSTROPHY, LIMB-GIRDLE, TYPE 2D
UNG	免疫缺陷伴高IgM	IMMUNODEFICIENCY WITH HYPER-IgM, TYPE 5
FSHR	卵巢过度刺激综合征	OVARIAN HYPERSTIMULATION SYNDROME
PRPH2	视网膜色素变性	RETINITIS PIGMENTOSA 7
PRPH2	黄斑营养不良	MACULAR DYSTROPHY, VITELLIFORM, 3
SPINK1	胰腺炎	TROPICAL CALCIFIC PANCREATITIS
RPGRIP1	锥杆营养不良	CONE-ROD DYSTROPHY 13
RAC2	嗜中性粒细胞免疫缺陷综合征	NEUTROPHIL IMMUNODEFICIENCY SYNDROME
AP3B1	Hermansky-Pudlak综合征	HERMANSKY-PUDLAK SYNDROME 2
ARHGEF10	神经传导减慢性肌病	SLOWED NERVE CONDUCTION VELOCITY, AUTOSOMAL DOMINANT
HGF	先天性耳聋	DEAFNESS, AUTOSOMAL RECESSIVE 39
CDC73	甲状旁腺癌	PARATHYROID CARCINOMA
YARS	腓骨肌萎缩症	CHARCOT-MARIE-TOOTH DISEASE, DOMINANT INTERMEDIATE C
GDAP1	腓骨肌萎缩症	CHARCOT-MARIE-TOOTH DISEASE, RECESSIVE INTERMEDIATE A
RASA1	毛细血管-动静脉畸形	CAPILLARY MALFORMATION-ARTERIOVENOUS MALFORMATION
MYH7	肌球蛋白储存肌病	MYOPATHY, MYOSIN STORAGE
CERKL	视网膜色素变性	RETINITIS PIGMENTOSA 26
SIX1	鳃耳综合征	BRANCHIOOTIC SYNDROME 3
SCN4A	肌强直症	MYOTONIA, POTASSIUM-AGGRAVATED
CENPJ	常染色体隐性遗传原发性小头畸形	MICROCEPHALY 6, PRIMARY, AUTOSOMAL RECESSIVE
CD36	血小板膜糖蛋白4缺乏症	PLATELET GLYCOPROTEIN IV DEFICIENCY
RGS9	长时间的视网膜电反应抑制	PROLONGED ELECTRORETINAL RESPONSE SUPPRESSION
MUTYH	家族性腺瘤性息肉病	FAMILIAL ADENOMATOUS POLYPOSIS, 2
TGFBI	角膜营养不良	CORNEAL DYSTROPHY OF BOWMAN LAYER, TYPE I
TGFBI	角膜营养不良	CORNEAL DYSTROPHY, LATTICE TYPE IIIA
ALG1	先天性糖基化障碍	CONGENITAL DISORDER OF GLYCOSYLATION, TYPE Ik
ESRRB	先天性耳聋	DEAFNESS, AUTOSOMAL RECESSIVE 35
SCN5A	病态窦房结综合征	SICK SINUS SYNDROME 1, AUTOSOMAL RECESSIVE
AGPAT2	先天性全身性脂肪营养不良	LIPODYSTROPHY, CONGENITAL GENERALIZED, TYPE 1
RPIA	异构酶缺乏症	RIBOSE 5-PHOSPHATE ISOMERASE DEFICIENCY
ZMPSTE24	颅骨下颌骨皮肤发育不全	MANDIBULOACRAL DYSPLASIA WITH TYPE B LIPODYSTROPHY
AXIN2	少牙畸形结直肠癌综合征	OLIGODONTIA-COLORECTAL CANCER SYNDROME
KCNMB1	高血压	HYPERTENSION, DIASTOLIC, RESISTANCE TO
VAPB	肌萎缩侧索硬化	AMYOTROPHIC LATERAL SCLEROSIS 8
AHI1	朱伯特综合征	JOUBERT SYNDROME 3
HSPB1	远端遗传性运动神经元病	NEURONOPATHY, DISTAL HEREDITARY MOTOR, TYPE IIB
DDC	氧化还原酶缺乏症	AROMATIC L-AMINO ACID DECARBOXYLASE DEFICIENCY
DNAH5	原发性纤毛运动障碍	CILIARY DYSKINESIA, PRIMARY, 3
SLC27A4	鱼鳞病	ICHTHYOSIS PREMATURITY SYNDROME
NGFB	感觉自主神经病	NEUROPATHY, HEREDITARY SENSORY AND AUTONOMIC, TYPE V
HSPB8	腓骨肌萎缩症	CHARCOT-MARIE-TOOTH DISEASE, AXONAL, TYPE 2L
MESP2	脊椎肋骨发育不全	SPONDYLOCOSTAL DYSOSTOSIS 2, AUTOSOMAL RECESSIVE
ATIC	水解酶缺乏症	AICAR TRANSFORMYLASE/IMP CYCLOHYDROLASE DEFICIENCY
LMNB2	脂肪代谢障碍	LIPODYSTROPHY, PARTIAL, ACQUIRED, SUSCEPTIBILITY TO
MATN3	脊椎干骺端发育不良	SPONDYLOEPIMETAPHYSEAL DYSPLASIA, MATRILIN-3 RELATED
MYL3	家族性肥厚型心肌病	CARDIOMYOPATHY, FAMILIAL HYPERTROPHIC, 8
MYL2	家族性肥厚型心肌病	CARDIOMYOPATHY, FAMILIAL HYPERTROPHIC, 10
ALG9	先天性糖基化障碍	CONGENITAL DISORDER OF GLYCOSYLATION, TYPE Il
COG7	先天性糖基化障碍	CONGENITAL DISORDER OF GLYCOSYLATION, TYPE IIe
PDP1	氧化还原酶缺乏症	PYRUVATE DEHYDROGENASE PHOSPHATASE DEFICIENCY
DPM1	先天性糖基化障碍	CONGENITAL DISORDER OF GLYCOSYLATION, TYPE Ie
GJC2	脑白质营养不良伴髓鞘发育不良	LEUKODYSTROPHY, HYPOMYELINATING, 2
COL2A1	股骨头缺血性坏死	AVASCULAR NECROSIS OF FEMORAL HEAD, PRIMARY
MED13L	右向襻转型小儿大动脉错位	TRANSPOSITION OF THE GREAT ARTERIES, DEXTRO-LOOPED 1
CRYAB	肌纤维肌病	MYOPATHY, MYOFIBRILLAR, 2
CPT2	转移酶缺乏症	CARNITINE PALMITOYLTRANSFERASE II DEFICIENCY, LETHAL NEONATAL
MYH8	Carney综合征	CARNEY COMPLEX VARIANT
LARGE	肌营养不良-抗肌萎缩相关糖蛋白病	MUSCULAR DYSTROPHY-DYSTROGLYCANOPATHY (CONGENITAL WITH MENTAL RETARDATION),
MSX1	先天性唇腭裂	OROFACIAL CLEFT 5
FBLN5	黄斑变性	MACULAR DEGENERATION, AGE-RELATED, 3
UNC13D	噬血细胞性淋巴组织细胞增多症	HEMOPHAGOCYTIC LYMPHOHISTIOCYTOSIS, FAMILIAL, 3
CHRNA1	肌无力综合征	MYASTHENIC SYNDROME, CONGENITAL, FAST-CHANNEL
CHRND	肌无力综合征	MYASTHENIC SYNDROME, CONGENITAL, FAST-CHANNEL
CHRNE	肌无力综合征	MYASTHENIC SYNDROME, CONGENITAL, FAST-CHANNEL
TGFBR1	Loeys-Dietz综合征	LOEYS-DIETZ SYNDROME, TYPE 2A
WT1	Meacham综合征	MEACHAM SYNDROME
FREM1	鼻裂伴有或不伴有肛肠肾脏畸形	BIFID NOSE WITH OR WITHOUT ANORECTAL AND RENAL ANOMALIES
FOXL2	卵巢早衰	PREMATURE OVARIAN FAILURE 3
HADHA	三种功能蛋白缺乏症	TRIFUNCTIONAL PROTEIN DEFICIENCY
HADHB	三种功能蛋白缺乏症	TRIFUNCTIONAL PROTEIN DEFICIENCY
HADHA	氧化还原酶缺乏症	LONG-CHAIN 3-HYDROXYACYL-CoA DEHYDROGENASE DEFICIENCY
FLVCR1	后柱性共济失调伴视网膜色素变性	POSTERIOR COLUMN ATAXIA WITH RETINITIS PIGMENTOSA
PKP2	致心律失常性右室心肌病	ARRHYTHMOGENIC RIGHT VENTRICULAR DYSPLASIA, FAMILIAL, 9
LAMB2	Pierson综合征	PIERSON SYNDROME
FANCI	范可尼贫血	FANCONI ANEMIA, COMPLEMENTATION GROUP I
BRIP1	范可尼贫血	FANCONI ANEMIA, COMPLEMENTATION GROUP J
SIAT9	AMISH小儿癫痫综合征	AMISH INFANTILE EPILEPSY SYNDROME
CD151	肾病伴前胫表皮松解大疱性和耳聋	NEPHROPATHY WITH PRETIBIAL EPIDERMOLYSIS BULLOSA AND DEAFNESS
GFM1	组合型氧化磷酸化缺陷症	COMBINED OXIDATIVE PHOSPHORYLATION DEFICIENCY 1
PTF1A	永久性新生儿糖尿病	PANCREATIC AND CEREBELLAR AGENESIS
SOX10	脱髓鞘周围神经病,中心髓鞘形成障碍伴Waardenburg综合征及hirschsprung病	PERIPHERAL DEMYELINATING NEUROPATHY, CENTRAL DYSMYELINATION, WAARDENBURG
COL8A2	角膜营养不良	CORNEAL DYSTROPHY, POSTERIOR POLYMORPHOUS, 2
ZEB1	角膜营养不良	CORNEAL DYSTROPHY, POSTERIOR POLYMORPHOUS, 3
TSHR	非自身免疫性甲状腺机能亢进	HYPERTHYROIDISM, NONAUTOIMMUNE
KRT10	鱼鳞病	ERYTHRODERMA, ICHTHYOSIFORM, CONGENITAL RETICULAR
MPDU1	先天性糖基化障碍	CONGENITAL DISORDER OF GLYCOSYLATION, TYPE If
MYOT	肌纤维肌病	MYOPATHY, MYOFIBRILLAR, 3
PLOD2	Bruck综合征	BRUCK SYNDROME 2
MLPH	格里塞利综合征	GRISCELLI SYNDROME, TYPE 3
NAGA	Schindler病	SCHINDLER DISEASE, TYPE I
NAGA	Kanzaki病	KANZAKI DISEASE
IQCB1	senior-loken综合征	SENIOR-LOKEN SYNDROME 5
MFN2	腓骨肌萎缩症	CHARCOT-MARIE-TOOTH DISEASE, AXONAL, TYPE 2A2
CHEK2	李-佛美尼综合征	LI-FRAUMENI SYNDROME 2
KBTBD13	线状体肌病	NEMALINE MYOPATHY 6
SLC25A4	进行性眼外肌麻痹	PROGRESSIVE EXTERNAL OPHTHALMOPLEGIA WITH MITOCHONDRIAL DNA DELETIONS,
TPM3	线状体肌病	NEMALINE MYOPATHY 1
TPM2	线状体肌病	NEMALINE MYOPATHY 4
C10orf2	进行性眼外肌麻痹	PROGRESSIVE EXTERNAL OPHTHALMOPLEGIA WITH MITOCHONDRIAL DNA DELETIONS,
SLC25A22	癫痫	EPILEPTIC ENCEPHALOPATHY, EARLY INFANTILE, 3
FGF14	脊髓小脑性共济失调	SPINOCEREBELLAR ATAXIA 27
POMT1	肌营养不良-抗肌萎缩相关糖蛋白病	MUSCULAR DYSTROPHY-DYSTROGLYCANOPATHY (LIMB-GIRDLE), TYPE C, 1
MLH1	大肠癌	COLORECTAL CANCER, HEREDITARY NONPOLYPOSIS, TYPE 2
FGD4	腓骨肌萎缩症	CHARCOT-MARIE-TOOTH DISEASE, TYPE 4H
SMARCB1	杆状易患病体质综合征	RHABDOID TUMOR PREDISPOSITION SYNDROME 1
PPARG	颈动脉内膜中层厚度1	CAROTID INTIMAL MEDIAL THICKNESS 1
KRT5	单纯型大疱性表皮松解症	EPIDERMOLYSIS BULLOSA SIMPLEX WITH MIGRATORY CIRCINATE ERYTHEMA
KCNMA1	全身性癫痫及发作性运动障碍	GENERALIZED EPILEPSY AND PAROXYSMAL DYSKINESIA
LDB3	肌纤维肌病	MYOPATHY, MYOFIBRILLAR, 4
KIAA1279	Goldberg-Shprintzen巨结肠症综合征	GOLDBERG-SHPRINTZEN SYNDROME
NOD2	结节病	SARCOIDOSIS, EARLY-ONSET
COL2A1	斯蒂克勒综合征	STICKLER SYNDROME, TYPE I, NONSYNDROMIC OCULAR
SNAP29	鱼鳞病	CEREBRAL DYSGENESIS, NEUROPATHY, ICHTHYOSIS, AND PALMOPLANTAR KERATODERMA
PCDH15	先天性耳聋	DEAFNESS, AUTOSOMAL RECESSIVE 23
CYP2C9	CYP2C19相关的不良型药物代谢	DRUG METABOLISM, POOR, CYP2C19-RELATED
C5	补体成分缺乏症	COMPLEMENT COMPONENT 5 DEFICIENCY
MFRP	真性小眼球	NANOPHTHALMOS 2
FGFR2	舟形头畸形,上颌后移伴智力低下	SCAPHOCEPHALY, MAXILLARY RETRUSION, AND MENTAL RETARDATION
ALX4	顶骨发育不全	PARIETAL FORAMINA 2
KCNH2	短QT综合征	SHORT QT SYNDROME 1
KCNQ1	短QT综合征	SHORT QT SYNDROME 2
SCN1A	偏瘫性偏头痛	MIGRAINE, FAMILIAL HEMIPLEGIC, 3
DSP	大疱性表皮松解症	EPIDERMOLYSIS BULLOSA, LETHAL ACANTHOLYTIC
SECISBP2	甲状腺激素代谢异常	THYROID HORMONE METABOLISM, ABNORMAL
COL11A2	先天性耳聋	DEAFNESS, AUTOSOMAL RECESSIVE 53
POMC	阿黑皮素原缺乏症	PROOPIOMELANOCORTIN DEFICIENCY
CRYBB3	白内障	CATARACT 22, MULTIPLE TYPES
TGM5	皮肤剥脱综合征	PEELING SKIN SYNDROME 2
CEL	青年发病的成年型糖尿病	MATURITY-ONSET DIABETES OF THE YOUNG, TYPE 8, WITH EXOCRINE DYSFUNCTION
LFNG	脊椎肋骨发育不全	SPONDYLOCOSTAL DYSOSTOSIS 3, AUTOSOMAL RECESSIVE
CFH	补体因子缺乏症	COMPLEMENT FACTOR H DEFICIENCY
EGLN1	家族性红细胞增多症	ERYTHROCYTOSIS, FAMILIAL, 3
P2RY12	血小板型出血障碍	BLEEDING DISORDER, PLATELET-TYPE, 8
TRIOBP	先天性耳聋	DEAFNESS, AUTOSOMAL RECESSIVE 28
UMOD	肾小球囊肿病伴高尿酸血症和等渗尿	GLOMERULOCYSTIC KIDNEY DISEASE WITH HYPERURICEMIA AND ISOSTHENURIA
WDR36	开角型青光眼	GLAUCOMA 1, OPEN ANGLE, G
RAG1	α/βT细胞淋巴球减少症	ALPHA/BETA T-CELL LYMPHOPENIA WITH GAMMA/DELTA T-CELL EXPANSION, SEVERE
KRAS	努南综合征	NOONAN SYNDROME 3
HADH	高胰岛素低血糖症	HYPERINSULINEMIC HYPOGLYCEMIA, FAMILIAL, 4
CLN8	神经元蜡样质脂褐质沉积症	CEROID LIPOFUSCINOSIS, NEURONAL, 8, NORTHERN EPILEPSY VARIANT
ACADSB	氧化还原酶缺乏症	2-@METHYLBUTYRYL-CoA DEHYDROGENASE DEFICIENCY
GLUL	先天性谷酰胺缺乏症	GLUTAMINE DEFICIENCY, CONGENITAL
GDF5	多发性骨性连接综合征	MULTIPLE SYNOSTOSES SYNDROME 2
TUBB2B	多小脑回畸形	POLYMICROGYRIA, SYMMETRIC OR ASYMMETRIC
CNTNAP2	脑皮质发育不全伴病灶性癫痫综合征	CORTICAL DYSPLASIA-FOCAL EPILEPSY SYNDROME
DCN	角膜营养不良	CORNEAL DYSTROPHY, CONGENITAL STROMAL
PNPO	氧化还原酶缺乏症	PYRIDOXAMINE 5-PRIME-PHOSPHATE OXIDASE DEFICIENCY
VSX2	孤立型小眼畸形伴眼缺损	MICROPHTHALMIA, ISOLATED, WITH COLOBOMA 3
VSX2	孤立型小眼畸形	MICROPHTHALMIA, ISOLATED 2
C7	补体成分缺乏症	COMPLEMENT COMPONENT 7 DEFICIENCY
OTX2	小眼畸形综合征	MICROPHTHALMIA, SYNDROMIC 5
CTSD	神经元蜡样质脂褐质沉积症	CEROID LIPOFUSCINOSIS, NEURONAL, 10
POLG2	进行性眼外肌麻痹	PROGRESSIVE EXTERNAL OPHTHALMOPLEGIA WITH MITOCHONDRIAL DNA DELETIONS,
LMNA	Slovenian型心-手综合征	HEART-HAND SYNDROME, SLOVENIAN TYPE
MARVELD2	先天性耳聋	DEAFNESS, AUTOSOMAL RECESSIVE 49
INPP5E	智力低下伴肢体肥大,视网膜发育不良,小阴茎	MENTAL RETARDATION, TRUNCAL OBESITY, RETINAL DYSTROPHY, AND MICROPENIS
CD247	免疫缺陷	IMMUNODEFICIENCY 25
TGFBR2	Loeys-Dietz综合征	LOEYS-DIETZ SYNDROME 2
RNASEH2B	Aicardi-Goutieres综合征	AICARDI-GOUTIERES SYNDROME 2
ZFPM2	膈疝	DIAPHRAGMATIC HERNIA 3
CEP290	朱伯特综合征	JOUBERT SYNDROME 5
DSG2	致心律失常性右室心肌病	ARRHYTHMOGENIC RIGHT VENTRICULAR DYSPLASIA, FAMILIAL, 10
DNAJC19	三甲基戊烯二酸尿症	3-@METHYLGLUTACONIC ACIDURIA, TYPE V
MAF	白内障	CATARACT 21, MULTIPLE TYPES
NOTCH2	Alagille综合征	ALAGILLE SYNDROME 2
PLA2G6	大脑铁沉积性神经退行性变	NEURODEGENERATION WITH BRAIN IRON ACCUMULATION 2B
DFNB59	先天性耳聋	DEAFNESS, AUTOSOMAL RECESSIVE 59
PDYN	脊髓小脑性共济失调	SPINOCEREBELLAR ATAXIA 23
AFG3L2	脊髓小脑性共济失调	SPINOCEREBELLAR ATAXIA 28
EHMT1	Kleefstra综合征	KLEEFSTRA SYNDROME
FOXE3	先天性原发性无晶体眼	APHAKIA, CONGENITAL PRIMARY
LHFPL5	先天性耳聋	DEAFNESS, AUTOSOMAL RECESSIVE 67
SEMA4A	视网膜色素变性	RETINITIS PIGMENTOSA 35
SEMA4A	锥杆营养不良	CONE-ROD DYSTROPHY 10
HTRA2	遗传性帕金森病	PARKINSON DISEASE 13, AUTOSOMAL DOMINANT, SUSCEPTIBILITY TO
CLCF1	冷诱导出汗综合征	COLD-INDUCED SWEATING SYNDROME 2
RNASEH2C	Aicardi-Goutieres综合征	AICARDI-GOUTIERES SYNDROME 3
RNASEH2A	Aicardi-Goutieres综合征	AICARDI-GOUTIERES SYNDROME 4
CHRNA2	癫痫	EPILEPSY, NOCTURNAL FRONTAL LOBE, 4
KCNV2	视锥细胞营养不良	RETINAL CONE DYSTROPHY 3B
MVK	甲羟戊酸尿	MEVALONIC ACIDURIA
TGFBR2	Loeys-Dietz综合征	LOEYS-DIETZ SYNDROME, TYPE 2B
RAXL1	锥杆营养不良	CONE-ROD DYSTROPHY 11
CRYBA4	白内障	CATARACT 23
CRYBA4	小眼畸形	MICROPHTHALMIA, ISOLATED, WITH CATARACT 4
GNAT1	先天性静止性夜盲症	NIGHT BLINDNESS, CONGENITAL STATIONARY, AUTOSOMAL DOMINANT 3
RHO	先天性静止性夜盲症	NIGHT BLINDNESS, CONGENITAL STATIONARY, AUTOSOMAL DOMINANT 1
TREX1	冻疮样狼疮	CHILBLAIN LUPUS 1
TPMT	转移酶缺乏症	THIOPURINE S-METHYLTRANSFERASE DEFICIENCY
FGFR3	指屈曲-高身材-听力受损综合征	CAMPTODACTYLY, TALL STATURE, AND HEARING LOSS SYNDROME
PDE11A	原发性色素性结节状肾上腺皮质病	PIGMENTED NODULAR ADRENOCORTICAL DISEASE, PRIMARY, 2
MRPS16	组合型氧化磷酸化缺陷症	COMBINED OXIDATIVE PHOSPHORYLATION DEFICIENCY 2
TSFM	组合型氧化磷酸化缺陷症	COMBINED OXIDATIVE PHOSPHORYLATION DEFICIENCY 3
KLF11	青年发病的成年型糖尿病	MATURITY-ONSET DIABETES OF THE YOUNG, TYPE 7
FAM126A	脑白质营养不良伴髓鞘发育不良	LEUKODYSTROPHY, HYPOMYELINATING, 5
PSAP	戈谢病	GAUCHER DISEASE, ATYPICAL, DUE TO SAPOSIN C DEFICIENCY
KCNJ11	新生儿暂时性糖尿病	DIABETES MELLITUS, TRANSIENT NEONATAL, 3
PRCD	视网膜色素变性	RETINITIS PIGMENTOSA 36
CYP11B2	氧化还原酶缺乏症	CORTICOSTERONE METHYLOXIDASE TYPE II DEFICIENCY
F12	遗传性血管性水肿	ANGIOEDEMA, HEREDITARY, TYPE III
PROK2	Kallmann综合征	HYPOGONADOTROPIC HYPOGONADISM 4 WITH OR WITHOUT ANOSMIA
RPS24	先天性纯红细胞再生障碍性贫血	DIAMOND-BLACKFAN ANEMIA 3
TUFM	组合型氧化磷酸化缺陷症	COMBINED OXIDATIVE PHOSPHORYLATION DEFICIENCY 4
CFL2	线状体肌病	NEMALINE MYOPATHY 7
CFH	黄斑变性	MACULAR DEGENERATION, AGE-RELATED, 4
PNPLA2	中性脂肪沉积症伴肌病	NEUTRAL LIPID STORAGE DISEASE WITH MYOPATHY
PLCE1	肾病综合征	NEPHROTIC SYNDROME, TYPE 3
HAX1	中性粒细胞减少症	NEUTROPENIA, SEVERE CONGENITAL, 3, AUTOSOMAL RECESSIVE
SYNE1	脊髓小脑性共济失调	SPINOCEREBELLAR ATAXIA, AUTOSOMAL RECESSIVE 8
CDKN1B	多发性内分泌腺瘤病	MULTIPLE ENDOCRINE NEOPLASIA, TYPE IV
ERCC2	脑额骨综合征	CEREBROOCULOFACIOSKELETAL SYNDROME 2
ST14	鱼鳞病	ICHTHYOSIS WITH HYPOTRICHOSIS, AUTOSOMAL RECESSIVE
SLC25A3	线粒体磷载体缺乏	MITOCHONDRIAL PHOSPHATE CARRIER DEFICIENCY
PALB2	范可尼贫血	FANCONI ANEMIA, COMPLEMENTATION GROUP N
TXNDC3	原发性纤毛运动障碍	CILIARY DYSKINESIA, PRIMARY, 6
ROBO2	膀胱输尿管返流	VESICOURETERAL REFLUX 2
SIX5	鳃-耳-肾综合征	BRANCHIOOTORENAL SYNDROME 2
SFTPC	肺表面活性物质代谢功能障碍	SURFACTANT METABOLISM DYSFUNCTION, PULMONARY, 2
LEPRE1	成骨不全症	OSTEOGENESIS IMPERFECTA, TYPE VIII
ABCA3	肺表面活性物质代谢功能障碍	SURFACTANT METABOLISM DYSFUNCTION, PULMONARY, 3
MFSD8	神经元蜡样质脂褐质沉积症	CEROID LIPOFUSCINOSIS, NEURONAL, 7
TCF4	Pitt-Hopkins综合征	PITT-HOPKINS SYNDROME
PSAT1	转移酶缺乏症	PHOSPHOSERINE AMINOTRANSFERASE DEFICIENCY
RAX	孤立型小眼畸形	MICROPHTHALMIA, ISOLATED 3
DARS2	脑白质病	LEUKOENCEPHALOPATHY WITH BRAINSTEM AND SPINAL CORD INVOLVEMENT AND
ACAD9	氧化还原酶缺乏症	MITOCHONDRIAL COMPLEX I DEFICIENCY DUE TO ACAD9 DEFICIENCY
FCGR2B	疟疾,易感性	MALARIA, SUSCEPTIBILITY TO
TIRAP	疟疾,易感性	MALARIA, SUSCEPTIBILITY TO
COG8	先天性糖基化障碍	CONGENITAL DISORDER OF GLYCOSYLATION, TYPE IIh
COG1	先天性糖基化障碍	CONGENITAL DISORDER OF GLYCOSYLATION, TYPE IIg
FIG4	腓骨肌萎缩症	CHARCOT-MARIE-TOOTH DISEASE, TYPE 4J
GABRG2	全身性癫痫伴热性惊厥附加症	GENERALIZED EPILEPSY WITH FEBRILE SEIZURES PLUS, TYPE 3
ACAD8	氧化还原酶缺乏症	ISOBUTYRYL-CoA DEHYDROGENASE DEFICIENCY
NHEJ1	复合型免疫缺陷	SEVERE COMBINED IMMUNODEFICIENCY WITH MICROCEPHALY, GROWTH RETARDATION,
ANO5	肌营养不良	MUSCULAR DYSTROPHY, LIMB-GIRDLE, TYPE 2L
PIP5K1C	先天致死性挛缩综合征	LETHAL CONGENITAL CONTRACTURE SYNDROME 3
NOG	短指症	BRACHYDACTYLY, TYPE B2
SPRED1	Legius综合征	LEGIUS SYNDROME
LPAR6	少毛症	HYPOTRICHOSIS, LOCALIZED, AUTOSOMAL RECESSIVE 3
TLR4	黄斑变性	MACULAR DEGENERATION, AGE-RELATED, 10
CBG	皮质类固醇结合球蛋白缺乏症	CORTICOSTEROID-BINDING GLOBULIN DEFICIENCY
CLCN7	骨硬化病	OSTEOPETROSIS,  AUTOSOMAL RECESSIVE 4
KCNE2	心房颤动	ATRIAL FIBRILLATION, FAMILIAL, 4
GLIS2	肾消耗病	NEPHRONOPHTHISIS 7
RARS2	脑桥小脑发育不全	PONTOCEREBELLAR HYPOPLASIA, TYPE 6
RAF1	豹皮综合征	LEOPARD SYNDROME 2
GYS1	糖原贮积症	GLYCOGEN STORAGE DISEASE 0, MUSCLE
SOX10	瓦登伯革氏症候群	WAARDENBURG SYNDROME, TYPE 2E
FKTN	肌营养不良-抗肌萎缩相关糖蛋白病	MUSCULAR DYSTROPHY-DYSTROGLYCANOPATHY (LIMB-GIRDLE), TYPE C, 4
SLC4A1	肾小管酸中毒	RENAL TUBULAR ACIDOSIS, DISTAL, WITH HEMOLYTIC ANEMIA
BFSP2	白内障	CATARACT 12, MULTIPLE TYPES
TUBA1A	无脑回畸形	LISSENCEPHALY 3
FKTN	扩张型心肌病	CARDIOMYOPATHY, DILATED, 1X
TTN	早发性肌病伴致命性心肌病	MYOPATHY, EARLY-ONSET, WITH FATAL CARDIOMYOPATHY
EGF	低镁血症	HYPOMAGNESEMIA 4, RENAL
MRPS22	组合型氧化磷酸化缺陷症	COMBINED OXIDATIVE PHOSPHORYLATION DEFICIENCY 5
KCTD7	癫痫	EPILEPSY, PROGRESSIVE MYOCLONIC, 3, WITH OR WITHOUT INTRACELLULAR
NALP12	家族性寒冷性荨麻疹	FAMILIAL COLD AUTOINFLAMMATORY SYNDROME 2
APOE	脂蛋白肾小球病	LIPOPROTEIN GLOMERULOPATHY
COL4A1	遗传性血管病伴肾病,动脉瘤和肌肉痉挛	ANGIOPATHY, HEREDITARY, WITH NEPHROPATHY, ANEURYSMS, AND MUSCLE CRAMPS
GPD1L	Brugada综合征	BRUGADA SYNDROME 2
EPAS1	家族性红细胞增多症	ERYTHROCYTOSIS, FAMILIAL, 4
ACTA2	主动脉瘤	AORTIC ANEURYSM, FAMILIAL THORACIC 6
EPB41	椭圆形红细胞增多症	ELLIPTOCYTOSIS 1
BEST1	抗肌萎缩蛋白病	BESTROPHINOPATHY, AUTOSOMAL RECESSIVE
WNT4	46,性反转	46,XX SEX REVERSAL WITH DYSGENESIS OF KIDNEYS, ADRENALS, AND LUNGS
CAV3	长Q-T间期综合征	LONG QT SYNDROME 9
SCN4B	长Q-T间期综合征	LONG QT SYNDROME 10
AKAP9	长Q-T间期综合征	LONG QT SYNDROME 11
CACNA1C	Brugada综合征	BRUGADA SYNDROME 3
CACNB2	Brugada综合征	BRUGADA SYNDROME 4
TPM1	扩张型心肌病	CARDIOMYOPATHY, DILATED, 1Y
TNNC1	扩张型心肌病	CARDIOMYOPATHY, DILATED, 1Z
ALDOA	糖原贮积症	GLYCOGEN STORAGE DISEASE XII
DNAH11	原发性纤毛运动障碍	CILIARY DYSKINESIA, PRIMARY, 7
GLE1	致命性关节弯曲伴前角细胞疾病	LETHAL ARTHROGRYPOSIS WITH ANTERIOR HORN CELL DISEASE
ANG	肌萎缩侧索硬化	AMYOTROPHIC LATERAL SCLEROSIS 9
CASQ2	室性心动过速	VENTRICULAR TACHYCARDIA, CATECHOLAMINERGIC POLYMORPHIC, 2
CST3	黄斑变性	MACULAR DEGENERATION, AGE-RELATED, 11
RFT1	先天性糖基化障碍	CONGENITAL DISORDER OF GLYCOSYLATION, TYPE In
ADCK3	辅酶Q10缺陷症	COENZYME Q10 DEFICIENCY, PRIMARY, 4
SLC16A12	白内障	CATARACT, JUVENILE, WITH MICROCORNEA AND GLUCOSURIA
PNPLA6	遗传性痉挛性截瘫	SPASTIC PARAPLEGIA 39, AUTOSOMAL RECESSIVE
PRKRA	肌张力障碍	DYSTONIA 16
TARDBP	肌萎缩侧索硬化	AMYOTROPHIC LATERAL SCLEROSIS 10 WITH OR WITHOUT FRONTOTEMPORAL DEMENTIA
SUCLA2	线粒体DNA缺失综合征	MITOCHONDRIAL DNA DEPLETION SYNDROME 5 (ENCEPHALOMYOPATHIC WITH OR
SLC2A9	肾性低尿酸血症	HYPOURICEMIA, RENAL, 2
RBM28	脱发,神经系统的缺陷和内分泌失调综合征	ALOPECIA, NEUROLOGIC DEFECTS, AND ENDOCRINOPATHY SYNDROME
ACTC1	家族性肥厚型心肌病	CARDIOMYOPATHY, FAMILIAL HYPERTROPHIC, 11
CSRP3	家族性肥厚型心肌病	CARDIOMYOPATHY, FAMILIAL HYPERTROPHIC, 12
SLC2A1	葡萄糖转运蛋白1缺陷综合征	GLUT1 DEFICIENCY SYNDROME 2
NFKBIA	无汗性外胚层发育不良伴T细胞缺乏	ECTODERMAL DYSPLASIA, ANHIDROTIC, WITH T-CELL IMMUNODEFICIENCY, AUTOSOMAL
ACTN2	扩张型心肌病	CARDIOMYOPATHY, DILATED, 1AA
STXBP1	癫痫	EPILEPTIC ENCEPHALOPATHY, EARLY INFANTILE, 4
PAX4	青年发病的成年型糖尿病	MATURITY-ONSET DIABETES OF THE YOUNG, TYPE 9
HSPD1	脑白质营养不良伴髓鞘发育不良	LEUKODYSTROPHY, HYPOMYELINATING, 4
KCNA5	心房颤动	ATRIAL FIBRILLATION, FAMILIAL, 7
PTEN	10q23染色体缺失综合征	CHROMOSOME 10q23 DELETION SYNDROME
FGFR3	Crouzon综合征	CROUZON SYNDROME WITH ACANTHOSIS NIGRICANS
TPCN2	皮肤/头发/眼睛色素沉着	SKIN/HAIR/EYE PIGMENTATION, VARIATION IN, 10
NIPAL4	鱼鳞病	ICHTHYOSIS, CONGENITAL, AUTOSOMAL RECESSIVE 6
CC2D2A	Meckel综合征	MECKEL SYNDROME, TYPE 6
CC2D2A	朱伯特综合征	JOUBERT SYNDROME 9
SLC34A1	肾结石/骨质疏松症,低血磷酸盐	NEPHROLITHIASIS/OSTEOPOROSIS, HYPOPHOSPHATEMIC, 1
SLC9A3R1	肾结石/骨质疏松症,低血磷酸盐	NEPHROLITHIASIS/OSTEOPOROSIS, HYPOPHOSPHATEMIC, 2
HOXA2	小耳畸形,听力障碍和颚裂	MICROTIA, HEARING IMPAIRMENT, AND CLEFT PALATE
ARL13B	朱伯特综合征	JOUBERT SYNDROME 8
KCNK9	Birk-Barel智力低下异形综合征	BIRK-BAREL MENTAL RETARDATION DYSMORPHISM SYNDROME
TNFRSF11A	骨硬化病	OSTEOPETROSIS, AUTOSOMAL RECESSIVE 7
PROC	易栓症	THROMBOPHILIA DUE TO PROTEIN C DEFICIENCY, AUTOSOMAL RECESSIVE
PROS1	易栓症	THROMBOPHILIA DUE TO PROTEIN S DEFICIENCY, AUTOSOMAL DOMINANT
KCNE1	耶韦尔和朗格-尼尔森综合征	JERVELL AND LANGE-NIELSEN SYNDROME 2
SLC39A13	Ehlers-Danlos综合征	SPONDYLOCHEIRODYSPLASIA, EHLERS-DANLOS SYNDROME-LIKE
HCF2	肝素辅因子II缺乏症	HEPARIN COFACTOR II DEFICIENCY
SDHB	Cowden综合征	COWDEN SYNDROME 2
SDHD	Cowden综合征	COWDEN SYNDROME 2
CHD7	Kallmann综合征	HYPOGONADOTROPIC HYPOGONADISM 5 WITH OR WITHOUT ANOSMIA
TSEN2	脑桥小脑发育不全	PONTOCEREBELLAR HYPOPLASIA, TYPE 2B
TSEN34	脑桥小脑发育不全	PONTOCEREBELLAR HYPOPLASIA, TYPE 2C
PLOD3	骨质脆弱伴挛缩,动脉破裂,耳聋	BONE FRAGILITY WITH CONTRACTURES, ARTERIAL RUPTURE, AND DEAFNESS
TNNT2	家族性限制性心肌病	CARDIOMYOPATHY, FAMILIAL RESTRICTIVE, 3
KLKB1	水解酶缺乏症	PREKALLIKREIN DEFICIENCY
PRICKLE1	癫痫	EPILEPSY, PROGRESSIVE MYOCLONIC, 1B
DNAI2	原发性纤毛运动障碍	CILIARY DYSKINESIA, PRIMARY, 9
ZBTB16	骨骼发育缺陷伴生殖器发育不良,智力低下	SKELETAL DEFECTS, GENITAL HYPOPLASIA, AND MENTAL RETARDATION
GNAS	假-假性甲状旁腺功能减退症	PSEUDOPSEUDOHYPOPARATHYROIDISM
WT1	肾母细胞瘤，无虹膜，泌尿生殖系统异常，智力低下	WILMS TUMOR, ANIRIDIA, GENITOURINARY ANOMALIES, MENTAL RETARDATION,
CAV1	先天性全身性脂肪营养不良	LIPODYSTROPHY, CONGENITAL GENERALIZED, TYPE 3
RPS17	先天性纯红细胞再生障碍性贫血	DIAMOND-BLACKFAN ANEMIA 4
RPL35A	先天性纯红细胞再生障碍性贫血	DIAMOND-BLACKFAN ANEMIA 5
G6PC3	中性粒细胞减少症	NEUTROPENIA, SEVERE CONGENITAL, 4, AUTOSOMAL RECESSIVE
FUT2	血浆维生素B12的数量性状位点1	VITAMIN B12 PLASMA LEVEL QUANTITATIVE TRAIT LOCUS 1
ADIPOQ	脂联素血清水平数量性状位点1	ADIPONECTIN, SERUM LEVEL OF, QUANTITATIVE TRAIT LOCUS 1
RPS7	先天性纯红细胞再生障碍性贫血	DIAMOND-BLACKFAN ANEMIA 8
IL10RB	炎症性肠病	INFLAMMATORY BOWEL DISEASE 25, AUTOSOMAL RECESSIVE
IDH3B	视网膜色素变性	RETINITIS PIGMENTOSA 46
FIG4	肌萎缩侧索硬化	AMYOTROPHIC LATERAL SCLEROSIS 11
CDH15	智力低下	MENTAL RETARDATION, AUTOSOMAL DOMINANT 3
SYNGAP1	智力低下	MENTAL RETARDATION, AUTOSOMAL DOMINANT 5
EDAR	头发形态1	HAIR MORPHOLOGY 1
AK1	溶血性贫血	ADENYLATE KINASE DEFICIENCY, HEMOLYTIC ANEMIA DUE TO
GJB6	先天性耳聋	DEAFNESS, AUTOSOMAL DOMINANT 3B
GJB3	先天性耳聋	DEAFNESS, AUTOSOMAL DOMINANT 2B
RSPH4A	原发性纤毛运动障碍	CILIARY DYSKINESIA, PRIMARY, 11
ICK	骨发育不良	ENDOCRINE-CEREBROOSTEODYSPLASIA
SLC4A1	球形红细胞增多症	SPHEROCYTOSIS, TYPE 4
SLC1A3	周期性共济失调	EPISODIC ATAXIA, TYPE 6
PROM1	锥杆营养不良	CONE-ROD DYSTROPHY 12
EPB42	球形红细胞增多症	SPHEROCYTOSIS, TYPE 5
CD79B	无丙种球蛋白血症	AGAMMAGLOBULINEMIA 6, AUTOSOMAL RECESSIVE
FGF8	Kallmann综合征	HYPOGONADOTROPIC HYPOGONADISM 6 WITH OR WITHOUT ANOSMIA
STIL	常染色体隐性遗传原发性小头畸形	MICROCEPHALY 7, PRIMARY, AUTOSOMAL RECESSIVE
RDH12	莱伯氏先天性黑矇	LEBER CONGENITAL AMAUROSIS 13
COX4I2	胰腺外分泌功能不全,红细胞生成障碍性贫血伴骨质增生症	EXOCRINE PANCREATIC INSUFFICIENCY, DYSERYTHROPOIETIC ANEMIA, AND CALVARIAL
SPR	肌张力障碍	DYSTONIA, DOPA-RESPONSIVE, DUE TO SEPIAPTERIN REDUCTASE DEFICIENCY
GATM	转移酶缺乏症	CEREBRAL CREATINE DEFICIENCY SYNDROME 3
GAMT	转移酶缺乏症	CEREBRAL CREATINE DEFICIENCY SYNDROME 2
ALAD	卟啉病	PORPHYRIA, ACUTE HEPATIC
ADAM9	锥杆营养不良	CONE-ROD DYSTROPHY 9
KCNJ10	癫痫,神经性耳聋,共济失调,智力缺陷和电解质紊乱	SEIZURES, SENSORINEURAL DEAFNESS, ATAXIA, MENTAL RETARDATION, AND
GHRHR	单一性生长素缺乏症	ISOLATED GROWTH HORMONE DEFICIENCY, TYPE IB
ORAI1	免疫缺陷	IMMUNODEFICIENCY 9
STIM1	免疫缺陷	IMMUNODEFICIENCY 10
ACAN	脊椎干骺端发育不良	SPONDYLOEPIMETAPHYSEAL DYSPLASIA, AGGRECAN TYPE
SCN1B	Brugada综合征	BRUGADA SYNDROME 5
FERMT3	白细胞粘附缺陷	LEUKOCYTE ADHESION DEFICIENCY, TYPE III
PAPSS2	脊椎干骺端发育不良	BRACHYOLMIA TYPE 4 WITH MILD EPIPHYSEAL AND METAPHYSEAL CHANGES
IL1RN	无菌多灶性骨髓炎伴骨膜炎和脓疱	OSTEOMYELITIS, STERILE MULTIFOCAL, WITH PERIOSTITIS AND PUSTULOSIS
TAB2	染色体6q24-Q25缺失综合征	CHROMOSOME 6q24-q25 DELETION SYNDROME
AMPD3	红细胞腺苷脱氨酶缺乏症	ERYTHROCYTE AMP DEAMINASE DEFICIENCY
DSG2	扩张型心肌病	CARDIOMYOPATHY, DILATED, 1BB
DSP	角化症掌跖病纹状体	KERATOSIS PALMOPLANTARIS STRIATA II
OBSL1	3M综合征	THREE M SYNDROME 2
CFI	非典型溶血性尿毒症综合征	HEMOLYTIC UREMIC SYNDROME, ATYPICAL, SUSCEPTIBILITY TO, 3
ENO3	糖原贮积症	GLYCOGEN STORAGE DISEASE XIII
AP4M1	遗传性痉挛性截瘫	SPASTIC PARAPLEGIA 50, AUTOSOMAL RECESSIVE
DPM3	先天性糖基化障碍	CONGENITAL DISORDER OF GLYCOSYLATION, TYPE Io
FTO	生长停滞,发育迟缓,面相异常和夭折综合征	GROWTH RETARDATION, DEVELOPMENTAL DELAY, COARSE FACIES, AND EARLY
PYCR1	皮肤松弛症	CUTIS LAXA, AUTOSOMAL RECESSIVE, TYPE IIB
KLHL7	视网膜色素变性	RETINITIS PIGMENTOSA 42
SLC25A12	大脑整体性髓鞘形成缺乏	HYPOMYELINATION, GLOBAL CEREBRAL
SAMHD1	Aicardi-Goutieres综合征	AICARDI-GOUTIERES SYNDROME 5
PLA2G6	遗传性帕金森病	PARKINSON DISEASE 14, AUTOSOMAL RECESSIVE
SNTA1	长Q-T间期综合征	LONG QT SYNDROME 12
FGF9	多发性骨性连接综合征	MULTIPLE SYNOSTOSES SYNDROME 3
NR5A1	卵巢早衰	PREMATURE OVARIAN FAILURE 7
NR5A1	46,性反转	46,XY SEX REVERSAL 3
BHLHE41	睡眠时间短	SHORT SLEEPER
TMEM126A	视神经萎缩	OPTIC ATROPHY 7 WITH OR WITHOUT AUDITORY NEUROPATHY
SYNE1	埃-德二氏肌营养不良	EMERY-DREIFUSS MUSCULAR DYSTROPHY 4, AUTOSOMAL DOMINANT
SYNE2	埃-德二氏肌营养不良	EMERY-DREIFUSS MUSCULAR DYSTROPHY 5, AUTOSOMAL DOMINANT
KRT16	掌跖角化病	PALMOPLANTAR KERATODERMA, NONEPIDERMOLYTIC, FOCAL
ITK	淋巴细胞增生综合征	LYMPHOPROLIFERATIVE SYNDROME 1
SCNN1A	支气管扩张	BRONCHIECTASIS WITH OR WITHOUT ELEVATED SWEAT CHLORIDE 2
PHKG2	糖原贮积症	GLYCOGEN STORAGE DISEASE IXc
PTEN	神经胶质瘤	GLIOMA SUSCEPTIBILITY 2
BRCA2	神经胶质瘤	GLIOMA SUSCEPTIBILITY 3
POU1F1	联合性垂体激素缺乏症	PITUITARY HORMONE DEFICIENCY, COMBINED, 1
FOLR1	大脑叶酸转运缺乏导致的神经退行性变	NEURODEGENERATION DUE TO CEREBRAL FOLATE TRANSPORT DEFICIENCY
TRMU	小儿急性肝功能衰竭	LIVER FAILURE, INFANTILE, TRANSIENT
MMP9	干骺端软骨发育不良	METAPHYSEAL ANADYSPLASIA 2
RIN2	大头畸形综合征	MACS SYNDROME
GFER	进行性线粒体肌病合并先天性白内障,听力损耗和发育迟滞	MYOPATHY, MITOCHONDRIAL PROGRESSIVE, WITH CONGENITAL CATARACT, HEARING
RRM2B	进行性眼外肌麻痹	PROGRESSIVE EXTERNAL OPHTHALMOPLEGIA WITH MITOCHONDRIAL DNA DELETIONS,
RAD50	奈梅亨断裂综合征样的障碍	NIJMEGEN BREAKAGE SYNDROME-LIKE DISORDER
LOXHD1	先天性耳聋	DEAFNESS, AUTOSOMAL RECESSIVE 77
CBX2	46,性反转	46,XY SEX REVERSAL 5
LTBP2	原发性先天性青光眼	GLAUCOMA 3, PRIMARY CONGENITAL, D
TLL1	房间隔缺损	ATRIAL SEPTAL DEFECT 6
CLCNKA	Bartter综合征	BARTTER SYNDROME, TYPE 4B
REN	高尿酸血症肾病	HYPERURICEMIC NEPHROPATHY, FAMILIAL JUVENILE, 2
PDE6C	视锥细胞营养不良	CONE DYSTROPHY 4
GDF6	孤立型小眼畸形	MICROPHTHALMIA, ISOLATED 4
PKD2	多囊肾病	POLYCYSTIC KIDNEY DISEASE 2
LTBP3	选择性牙齿发育不全	TOOTH AGENESIS, SELECTIVE, 6
MC1R	无痛觉自κ阿片样物质受体拮抗因子,雌性特异	INCREASED ANALGESIA FROM KAPPA-OPIOID RECEPTOR AGONIST, FEMALE-SPECIFIC
NTF4	开角型青光眼	GLAUCOMA 1, OPEN ANGLE, O
DSC3	少毛症和经常性水疱	HYPOTRICHOSIS AND RECURRENT SKIN VESICLES
PRPH2	中央晕轮状脉络膜萎缩	CHOROIDAL DYSTROPHY, CENTRAL AREOLAR 2
GFI1	中性粒细胞减少症	NEUTROPENIA, SEVERE CONGENITAL, 2, AUTOSOMAL DOMINANT
TUBB1	血小板减少症	MACROTHROMBOCYTOPENIA, AUTOSOMAL DOMINANT, TUBB1-RELATED
FAM134B	感觉自主神经病	NEUROPATHY, HEREDITARY SENSORY AND AUTONOMIC, TYPE IIB
HRG	血栓	THROMBOPHILIA DUE TO HISTIDINE-RICH GLYCOPROTEIN DEFICIENCY
KCNE3	Brugada综合征	BRUGADA SYNDROME 6
SCN3B	Brugada综合征	BRUGADA SYNDROME 7
NEXN	扩张型心肌病	CARDIOMYOPATHY, DILATED, 1CC
SLC6A3	少年遗传性肌张力不全-帕金森病	PARKINSONISM-DYSTONIA, INFANTILE
IL10RA	炎症性肠病	INFLAMMATORY BOWEL DISEASE 28, AUTOSOMAL RECESSIVE
POMT2	肌营养不良-抗肌萎缩相关糖蛋白病	MUSCULAR DYSTROPHY-DYSTROGLYCANOPATHY (CONGENITAL WITH BRAIN AND EYE
POMGNT1	肌营养不良-抗肌萎缩相关糖蛋白病	MUSCULAR DYSTROPHY-DYSTROGLYCANOPATHY (CONGENITAL WITH MENTAL RETARDATION),
FKTN	肌营养不良-抗肌萎缩相关糖蛋白病	MUSCULAR DYSTROPHY-DYSTROGLYCANOPATHY (CONGENITAL WITHOUT MENTAL RETARDATION),
FKRP	肌营养不良-抗肌萎缩相关糖蛋白病	MUSCULAR DYSTROPHY-DYSTROGLYCANOPATHY (CONGENITAL WITH BRAIN AND EYE
POMT1	肌营养不良-抗肌萎缩相关糖蛋白病	MUSCULAR DYSTROPHY-DYSTROGLYCANOPATHY (CONGENITAL WITH MENTAL RETARDATION),
POMGNT1	肌营养不良-抗肌萎缩相关糖蛋白病	MUSCULAR DYSTROPHY-DYSTROGLYCANOPATHY (LIMB-GIRDLE), TYPE C, 3
XPNPEP3	肾消耗病	NEPHRONOPHTHISIS-LIKE NEPHROPATHY 1
UPB1	水解酶缺乏症	BETA-UREIDOPROPIONASE DEFICIENCY
RBM20	扩张型心肌病	CARDIOMYOPATHY, DILATED, 1DD
PNP	水解酶缺乏症	PURINE NUCLEOSIDE PHOSPHORYLASE DEFICIENCY
TRAPPC9	智力低下	MENTAL RETARDATION, AUTOSOMAL RECESSIVE 13
DNAAF1	原发性纤毛运动障碍	CILIARY DYSKINESIA, PRIMARY, 13
BEST1	视网膜色素变性	RETINITIS PIGMENTOSA 50
ADAMTS17	Weill-Marchesani综合征	WEILL-MARCHESANI-LIKE SYNDROME
ITGA7	先天性肌营养不良	MUSCULAR DYSTROPHY, CONGENITAL, DUE TO INTEGRIN ALPHA-7 DEFICIENCY
LMNA	先天性肌营养不良	MUSCULAR DYSTROPHY, CONGENITAL, LMNA-RELATED
GJC2	遗传性痉挛性截瘫	SPASTIC PARAPLEGIA 44, AUTOSOMAL RECESSIVE
TRPM1	先天性静止性夜盲症	NIGHT BLINDNESS, CONGENITAL STATIONARY, TYPE 1C
F13A1	凝血因子缺乏症	FACTOR XIII, A SUBUNIT, DEFICIENCY OF
CA8	小脑性共济失调,智力低下和平衡失调综合征	CEREBELLAR ATAXIA, MENTAL RETARDATION, AND DYSEQUILIBRIUM SYNDROME
INF2	局灶性节段性肾小球硬化症	FOCAL SEGMENTAL GLOMERULOSCLEROSIS 5
MYH6	家族性肥厚型心肌病	CARDIOMYOPATHY, FAMILIAL HYPERTROPHIC, 14
MYH6	扩张型心肌病	CARDIOMYOPATHY, DILATED, 1EE
VCL	家族性肥厚型心肌病	CARDIOMYOPATHY, FAMILIAL HYPERTROPHIC, 15
EDN3	瓦登伯革氏症候群	WAARDENBURG SYNDROME, TYPE 4B
SOX10	瓦登伯革氏症候群	WAARDENBURG SYNDROME, TYPE 4C
SLC4A11	角膜营养不良	CORNEAL DYSTROPHY, FUCHS ENDOTHELIAL, 4
ZEB1	角膜营养不良	CORNEAL DYSTROPHY, FUCHS ENDOTHELIAL, 6
GRXCR1	先天性耳聋	DEAFNESS, AUTOSOMAL RECESSIVE 25
TNNI3	扩张型心肌病	CARDIOMYOPATHY, DILATED, 1FF
AARS	腓骨肌萎缩症	CHARCOT-MARIE-TOOTH DISEASE, AXONAL, TYPE 2N
SLC10A2	先天性胆汁酸合成缺陷	BILE ACID MALABSORPTION, PRIMARY
TPRN	先天性耳聋	DEAFNESS, AUTOSOMAL RECESSIVE 79
TSPAN12	渗出性玻璃体视网膜病	EXUDATIVE VITREORETINOPATHY 5
ENPP1	低磷酸盐血症性佝偻病	HYPOPHOSPHATEMIC RICKETS, AUTOSOMAL RECESSIVE, 2
HAMP	血色素沉着症	HEMOCHROMATOSIS, TYPE 2B
ANO5	肌营养不良	MIYOSHI MUSCULAR DYSTROPHY 3
SMARCA4	杆状易患病体质综合征	RHABDOID TUMOR PREDISPOSITION SYNDROME 2
PTRF	先天性全身性脂肪营养不良	LIPODYSTROPHY, CONGENITAL GENERALIZED, TYPE 4
SERPINE1	纤溶酶原激活物抑制因子1缺乏症	PLASMINOGEN ACTIVATOR INHIBITOR-1 DEFICIENCY
SCN4A	低钾性周期性麻痹	HYPOKALEMIC PERIODIC PARALYSIS, TYPE 2
SH3TC2	正中神经单神经病	MONONEUROPATHY OF THE MEDIAN NERVE, MILD
INS	青年发病的成年型糖尿病	MATURITY-ONSET DIABETES OF THE YOUNG, TYPE 10
RAD51C	范可尼贫血	FANCONI ANEMIA, COMPLEMENTATION GROUP O
PTPRQ	先天性耳聋	DEAFNESS, AUTOSOMAL RECESSIVE 84A
CD207	伯贝克颗粒缺乏	BIRBECK GRANULE DEFICIENCY
DDX11	华沙染色体断裂综合征	WARSAW BREAKAGE SYNDROME
PNKP	癫痫	MICROCEPHALY, SEIZURES, AND DEVELOPMENTAL DELAY
ACTC1	扩张型心肌病	CARDIOMYOPATHY, DILATED, 1R
C2orf71	视网膜色素变性	RETINITIS PIGMENTOSA 54
OPTN	肌萎缩侧索硬化	AMYOTROPHIC LATERAL SCLEROSIS 12
MEF2C	智力低下	MENTAL RETARDATION, AUTOSOMAL DOMINANT 20
ALX4	额鼻发育不良	FRONTONASAL DYSPLASIA 2
SERPINB6	先天性耳聋	DEAFNESS, AUTOSOMAL RECESSIVE 91
FOXG1	Rett综合征	RETT SYNDROME, CONGENITAL VARIANT
ALX1	额鼻发育不良	FRONTONASAL DYSPLASIA 3
TTC8	视网膜色素变性	RETINITIS PIGMENTOSA 51
GPI	溶血性贫血	HEMOLYTIC ANEMIA, NONSPHEROCYTIC, DUE TO GLUCOSE PHOSPHATE ISOMERASE
LBR	雷诺综合征	REYNOLDS SYNDROME
GJC2	遗传性淋巴水肿	LYMPHEDEMA, HEREDITARY, IC
KCNJ5	长Q-T间期综合征	LONG QT SYNDROME 13
COG4	先天性糖基化障碍	CONGENITAL DISORDER OF GLYCOSYLATION, TYPE IIj
CD81	常见变异型免疫缺陷病	IMMUNODEFICIENCY, COMMON VARIABLE, 6
IGLL1	无丙种球蛋白血症	AGAMMAGLOBULINEMIA 2, AUTOSOMAL RECESSIVE
CD79A	无丙种球蛋白血症	AGAMMAGLOBULINEMIA 3, AUTOSOMAL RECESSIVE
BLNK	无丙种球蛋白血症	AGAMMAGLOBULINEMIA 4, AUTOSOMAL RECESSIVE
GYG1	糖原贮积症	GLYCOGEN STORAGE DISEASE XV
CYP19A1	氧化还原酶缺乏症	AROMATASE DEFICIENCY
TMEM67	肾消耗病	NEPHRONOPHTHISIS 11
VWF	血管性血友病	VON WILLEBRAND DISEASE, TYPE 2
C12orf65	组合型氧化磷酸化缺陷症	COMBINED OXIDATIVE PHOSPHORYLATION DEFICIENCY 7
YARS2	肌病,乳酸性酸中毒和铁粒幼细胞性贫血	MYOPATHY, LACTIC ACIDOSIS, AND SIDEROBLASTIC ANEMIA 2
CBL	努南综合征	NOONAN SYNDROME-LIKE DISORDER WITH OR WITHOUT JUVENILE MYELOMONOCYTIC
POR	氧化还原酶缺乏症	DISORDERED STEROIDOGENESIS DUE TO CYTOCHROME P450 OXIDOREDUCTASE DEFICIENCY
PVRL4	外胚层发育不良-并指畸形综合征	ECTODERMAL DYSPLASIA-SYNDACTYLY SYNDROME 1
ARL6	视网膜色素变性	RETINITIS PIGMENTOSA 55
IMPG2	视网膜色素变性	RETINITIS PIGMENTOSA 56
PDE6G	视网膜色素变性	RETINITIS PIGMENTOSA 57
RP1L1	黄斑营养不良	OCCULT MACULAR DYSTROPHY
SDCCAG8	senior-loken综合征	SENIOR-LOKEN SYNDROME 7
ZNF513	视网膜色素变性	RETINITIS PIGMENTOSA 58
CHUK	腹茧综合征	COCOON SYNDROME
SPTLC2	感觉自主神经病	NEUROPATHY, HEREDITARY SENSORY AND AUTONOMIC, TYPE IC
KARS	腓骨肌萎缩症	CHARCOT-MARIE-TOOTH DISEASE, RECESSIVE INTERMEDIATE B
UCHL1	遗传性帕金森病	PARKINSON DISEASE 5, AUTOSOMAL DOMINANT, SUSCEPTIBILITY TO
C1QA	补体成分缺乏症	C1q DEFICIENCY
C1QC	补体成分缺乏症	C1q DEFICIENCY
C1QB	补体成分缺乏症	C1q DEFICIENCY
IDH2	戊二酸尿症	D-2-@HYDROXYGLUTARIC ACIDURIA 2
APC	胃癌	GASTRIC CANCER
ALG11	先天性糖基化障碍	CONGENITAL DISORDER OF GLYCOSYLATION, TYPE Ip
POLG	线粒体DNA缺失综合征	MITOCHONDRIAL DNA DEPLETION SYNDROME 4B (MNGIE TYPE)
MED17	小头畸形	MICROCEPHALY, POSTNATAL PROGRESSIVE, WITH SEIZURES AND BRAIN ATROPHY
FOXP1	智力低下	MENTAL RETARDATION WITH LANGUAGE IMPAIRMENT AND WITH OR WITHOUT AUTISTIC
SOBP	智力低下,前上颌前突和斜视	MENTAL RETARDATION, ANTERIOR MAXILLARY PROTRUSION, AND STRABISMUS
MTPAP	痉挛性共济失调	SPASTIC ATAXIA 4, AUTOSOMAL RECESSIVE
KLF1	先天性红细胞生成障碍贫血	ANEMIA, CONGENITAL DYSERYTHROPOIETIC, TYPE IV
SOX17	膀胱输尿管返流	VESICOURETERAL REFLUX 3
CENPJ	Seckel综合征	SECKEL SYNDROME 4
EP300	Rubinstein-Taybi综合征	RUBINSTEIN-TAYBI SYNDROME 2
HES7	脊椎肋骨发育不全	SPONDYLOCOSTAL DYSOSTOSIS 4, AUTOSOMAL RECESSIVE
KCNH2	长Q-T间期综合征	LONG QT SYNDROME 2
TNNI3	家族性肥厚型心肌病	CARDIOMYOPATHY, FAMILIAL HYPERTROPHIC, 7
KCNE2	长Q-T间期综合征	LONG QT SYNDROME 6
PSEN1	扩张型心肌病	CARDIOMYOPATHY, DILATED, 1U
KCNE1	长Q-T间期综合征	LONG QT SYNDROME 5
PSEN2	扩张型心肌病	CARDIOMYOPATHY, DILATED, 1V
GDF3	Klippel-Feil综合征(短颈畸形综合征)	KLIPPEL-FEIL SYNDROME 3, AUTOSOMAL DOMINANT
GDF3	孤立型小眼畸形伴眼缺损	MICROPHTHALMIA, ISOLATED, WITH COLOBOMA 6
GDF3	孤立型小眼畸形	MICROPHTHALMIA, ISOLATED 7
SLC25A19	硫胺素代谢障碍综合征	THIAMINE METABOLISM DYSFUNCTION SYNDROME 4 (BILATERAL STRIATAL DEGENERATION
GDNF	先天性巨结肠	HIRSCHSPRUNG DISEASE, SUSCEPTIBILITY TO, 3
POLR1D	下颌面骨发育不全	TREACHER COLLINS SYNDROME 2
MSRB3	先天性耳聋	DEAFNESS, AUTOSOMAL RECESSIVE 74
KCNQ2	癫痫	EPILEPTIC ENCEPHALOPATHY, EARLY INFANTILE, 7
SCN2A	癫痫	EPILEPTIC ENCEPHALOPATHY, EARLY INFANTILE, 11
ANO10	脊髓小脑性共济失调	SPINOCEREBELLAR ATAXIA, AUTOSOMAL RECESSIVE 10
RHO	视网膜色素变性	RETINITIS PIGMENTOSA 4
PSENEN	反常性痤疮	ACNE INVERSA, FAMILIAL, 2
PSEN1	反常性痤疮	ACNE INVERSA, FAMILIAL, 3
TMPO	扩张型心肌病	CARDIOMYOPATHY, DILATED, 1T
CYP11A1	46,性反转	ADRENAL INSUFFICIENCY, CONGENITAL, WITH 46,XY SEX REVERSAL, PARTIAL
JAM3	破坏性脑出血,室管膜下钙化,白内障	HEMORRHAGIC DESTRUCTION OF THE BRAIN, SUBEPENDYMAL CALCIFICATION,
SCP2	脑白质病	LEUKOENCEPHALOPATHY WITH DYSTONIA AND MOTOR NEUROPATHY
CDHR1	锥杆营养不良	CONE-ROD DYSTROPHY 15
ND5	MELAS综合征	MITOCHONDRIAL MYOPATHY, ENCEPHALOPATHY, LACTIC ACIDOSIS, AND STROKE-LIKE
AP5Z1	遗传性痉挛性截瘫	SPASTIC PARAPLEGIA 48, AUTOSOMAL RECESSIVE
KIAA0415	遗传性痉挛性截瘫	SPASTIC PARAPLEGIA 48, AUTOSOMAL RECESSIVE
CD320	甲基丙二酸尿症	METHYLMALONIC ACIDURIA DUE TO TRANSCOBALAMIN RECEPTOR DEFECT
ND6	MELAS综合征	MITOCHONDRIAL MYOPATHY, ENCEPHALOPATHY, LACTIC ACIDOSIS, AND STROKE-LIKE
HOGA1	转移酶缺乏症	HYPEROXALURIA, PRIMARY, TYPE III
TRNS2	MELAS综合征	MITOCHONDRIAL MYOPATHY, ENCEPHALOPATHY, LACTIC ACIDOSIS, AND STROKE-LIKE
TRNL1	MELAS综合征	MITOCHONDRIAL MYOPATHY, ENCEPHALOPATHY, LACTIC ACIDOSIS, AND STROKE-LIKE
COX3	MELAS综合征	MITOCHONDRIAL MYOPATHY, ENCEPHALOPATHY, LACTIC ACIDOSIS, AND STROKE-LIKE
TRNV	MELAS综合征	MITOCHONDRIAL MYOPATHY, ENCEPHALOPATHY, LACTIC ACIDOSIS, AND STROKE-LIKE
TRNK	MELAS综合征	MITOCHONDRIAL MYOPATHY, ENCEPHALOPATHY, LACTIC ACIDOSIS, AND STROKE-LIKE
LDLR	高胆固醇血症	HYPERCHOLESTEROLEMIA, FAMILIAL
DMD	肌营养不良	MUSCULAR DYSTROPHY, DUCHENNE TYPE
TRNK	先天性耳聋	DEAFNESS, NONSYNDROMIC SENSORINEURAL, MITOCHONDRIAL
TRNS2	先天性耳聋	DEAFNESS, NONSYNDROMIC SENSORINEURAL, MITOCHONDRIAL
HBA2	地中海贫血	ALPHA-THALASSEMIA
TRNK	癫痫	MYOCLONIC EPILEPSY ASSOCIATED WITH RAGGED-RED FIBERS
TRNL1	癫痫	MYOCLONIC EPILEPSY ASSOCIATED WITH RAGGED-RED FIBERS
TRNH	癫痫	MYOCLONIC EPILEPSY ASSOCIATED WITH RAGGED-RED FIBERS
TRNS1	癫痫	MYOCLONIC EPILEPSY ASSOCIATED WITH RAGGED-RED FIBERS
TRNS2	癫痫	MYOCLONIC EPILEPSY ASSOCIATED WITH RAGGED-RED FIBERS
TRNF	癫痫	MYOCLONIC EPILEPSY ASSOCIATED WITH RAGGED-RED FIBERS
HBA1	地中海贫血	ALPHA-THALASSEMIA
TRNE	线粒体肌病	MITOCHONDRIAL MYOPATHY WITH DIABETES
TRNS2	视网膜色素变性	RETINITIS PIGMENTOSA-DEAFNESS SYNDROME
TRNF	先天性耳聋	DEAFNESS, NONSYNDROMIC SENSORINEURAL, MITOCHONDRIAL
COX2	先天性耳聋	DEAFNESS, NONSYNDROMIC SENSORINEURAL, MITOCHONDRIAL
TRNW	先天性耳聋	DEAFNESS, NONSYNDROMIC SENSORINEURAL, MITOCHONDRIAL
CYTB	先天性耳聋	DEAFNESS, NONSYNDROMIC SENSORINEURAL, MITOCHONDRIAL
TRNS1	先天性耳聋	DEAFNESS, NONSYNDROMIC SENSORINEURAL, MITOCHONDRIAL
TRNE	先天性耳聋	DEAFNESS, NONSYNDROMIC SENSORINEURAL, MITOCHONDRIAL
HTT	亨廷顿病	HUNTINGTON DISEASE
ND1	MELAS综合征	MITOCHONDRIAL MYOPATHY, ENCEPHALOPATHY, LACTIC ACIDOSIS, AND STROKE-LIKE
TRNL2	MELAS综合征	MITOCHONDRIAL MYOPATHY, ENCEPHALOPATHY, LACTIC ACIDOSIS, AND STROKE-LIKE
TRNF	MELAS综合征	MITOCHONDRIAL MYOPATHY, ENCEPHALOPATHY, LACTIC ACIDOSIS, AND STROKE-LIKE
TRNE	MELAS综合征	MITOCHONDRIAL MYOPATHY, ENCEPHALOPATHY, LACTIC ACIDOSIS, AND STROKE-LIKE
ND4	Leber遗传性视神经病变	LEBER OPTIC ATROPHY AND DYSTONIA
TRNT	癫痫	MYOCLONIC EPILEPSY ASSOCIATED WITH RAGGED-RED FIBERS
TRNP	癫痫	MYOCLONIC EPILEPSY ASSOCIATED WITH RAGGED-RED FIBERS
ND3	MELAS综合征	MITOCHONDRIAL MYOPATHY, ENCEPHALOPATHY, LACTIC ACIDOSIS, AND STROKE-LIKE
RNR2	癫痫	MYOCLONIC EPILEPSY ASSOCIATED WITH RAGGED-RED FIBERS
EPCAM	大肠癌	COLORECTAL CANCER, HEREDITARY NONPOLYPOSIS, TYPE 8
CYTB	MELAS综合征	MITOCHONDRIAL MYOPATHY, ENCEPHALOPATHY, LACTIC ACIDOSIS, AND STROKE-LIKE
ND3	Leber遗传性视神经病变	LEBER OPTIC ATROPHY AND DYSTONIA
TRNH	先天性耳聋	DEAFNESS, NONSYNDROMIC SENSORINEURAL, MITOCHONDRIAL
ND1	先天性耳聋	DEAFNESS, NONSYNDROMIC SENSORINEURAL, MITOCHONDRIAL
TRNI	先天性耳聋	DEAFNESS, NONSYNDROMIC SENSORINEURAL, MITOCHONDRIAL
TRNQ	MELAS综合征	MITOCHONDRIAL MYOPATHY, ENCEPHALOPATHY, LACTIC ACIDOSIS, AND STROKE-LIKE
TRNH	MELAS综合征	MITOCHONDRIAL MYOPATHY, ENCEPHALOPATHY, LACTIC ACIDOSIS, AND STROKE-LIKE
TRNC	MELAS综合征	MITOCHONDRIAL MYOPATHY, ENCEPHALOPATHY, LACTIC ACIDOSIS, AND STROKE-LIKE
TRNS1	MELAS综合征	MITOCHONDRIAL MYOPATHY, ENCEPHALOPATHY, LACTIC ACIDOSIS, AND STROKE-LIKE
FMR1	X染色体脆折症运动失调症综合征	FRAGILE X TREMOR/ATAXIA SYNDROME
ND3	Kearns-Sayre综合征	KEARNS-SAYRE SYNDROME
COX1	Kearns-Sayre综合征	KEARNS-SAYRE SYNDROME
TRNL1	Kearns-Sayre综合征	KEARNS-SAYRE SYNDROME
TRNL2	Kearns-Sayre综合征	KEARNS-SAYRE SYNDROME
TRNT	线粒体肌病	MITOCHONDRIAL MYOPATHY, LETHAL, INFANTILE
DMPK	强直性肌营养不良	MYOTONIC DYSTROPHY 1
F9	血友病	HEMOPHILIA B
ATXN7	脊髓小脑性共济失调	SPINOCEREBELLAR ATAXIA 7
FECH	卟啉病	PROTOPORPHYRIA, ERYTHROPOIETIC
ABCC9	扩张型心肌病	CARDIOMYOPATHY, DILATED, 1O
PLN	扩张型心肌病	CARDIOMYOPATHY, DILATED, 1P
F11	凝血因子缺乏症	FACTOR XI DEFICIENCY
F5	凝血因子缺乏症	FACTOR V DEFICIENCY
RPL11	先天性纯红细胞再生障碍性贫血	DIAMOND-BLACKFAN ANEMIA 7
MYH7	扩张型心肌病	CARDIOMYOPATHY, DILATED, 1S
CPOX	卟啉病	COPROPORPHYRIA, HEREDITARY
ALAS2	卟啉病	PROTOPORPHYRIA, ERYTHROPOIETIC, X-LINKED
RPS19	先天性纯红细胞再生障碍性贫血	DIAMOND-BLACKFAN ANEMIA 1
TTBK2	脊髓小脑性共济失调	SPINOCEREBELLAR ATAXIA 11
ATXN2	脊髓小脑性共济失调	SPINOCEREBELLAR ATAXIA 2
RPS10	先天性纯红细胞再生障碍性贫血	DIAMOND-BLACKFAN ANEMIA 9
PPOX	卟啉病	PORPHYRIA VARIEGATA
RPS26	先天性纯红细胞再生障碍性贫血	DIAMOND-BLACKFAN ANEMIA 10
UROD	卟啉病	PORPHYRIA CUTANEA TARDA
TDP1	脊髓小脑性共济失调	SPINOCEREBELLAR ATAXIA, AUTOSOMAL RECESSIVE, WITH AXONAL NEUROPATHY
RARA	白血病	ACUTE PROMYELOCYTIC LEUKEMIA
BCR	白血病	LEUKEMIA, CHRONIC MYELOID
CEBPA	白血病	LEUKEMIA, ACUTE MYELOID
ZNF592	脊髓小脑性共济失调	SPINOCEREBELLAR ATAXIA, AUTOSOMAL RECESSIVE 5
TBP	脊髓小脑性共济失调	SPINOCEREBELLAR ATAXIA 17
PPP2R2B	脊髓小脑性共济失调	SPINOCEREBELLAR ATAXIA 12
CLCN5	低磷酸盐血症性佝偻病	HYPOPHOSPHATEMIC RICKETS, X-LINKED RECESSIVE
F8	血友病	HEMOPHILIA A
FANCC	范可尼贫血	FANCONI ANEMIA, COMPLEMENTATION GROUP C
FANCD2	范可尼贫血	FANCONI ANEMIA, COMPLEMENTATION GROUP D2
TRNL1	Leigh综合征	LEIGH SYNDROME
TRNK	Leigh综合征	LEIGH SYNDROME
ATP8	Kearns-Sayre综合征	KEARNS-SAYRE SYNDROME
CNBP	强直性肌营养不良	MYOTONIC DYSTROPHY 2
ND6	Leber遗传性视神经病变	LEBER OPTIC ATROPHY
ND4	Leber遗传性视神经病变	LEBER OPTIC ATROPHY
ND1	Leber遗传性视神经病变	LEBER OPTIC ATROPHY
ND4L	Leber遗传性视神经病变	LEBER OPTIC ATROPHY
CYTB	Leber遗传性视神经病变	LEBER OPTIC ATROPHY
ND2	Leber遗传性视神经病变	LEBER OPTIC ATROPHY
ATP7B	肝豆状核变性	WILSON DISEASE
ND5	Leber遗传性视神经病变	LEBER OPTIC ATROPHY
ATP6	Leber遗传性视神经病变	LEBER OPTIC ATROPHY
TRNQ	Leber遗传性视神经病变	LEBER OPTIC ATROPHY
COX2	Leber遗传性视神经病变	LEBER OPTIC ATROPHY
COX3	Leber遗传性视神经病变	LEBER OPTIC ATROPHY
APOB	高胆固醇血症	HYPERCHOLESTEROLEMIA, AUTOSOMAL DOMINANT, TYPE B
COL3A1	Ehlers-Danlos综合征	EHLERS-DANLOS SYNDROME, TYPE IV, AUTOSOMAL DOMINANT
PLOD1	Ehlers-Danlos综合征	EHLERS-DANLOS SYNDROME, TYPE VI
F2	凝血因子缺乏症	PROTHROMBIN DEFICIENCY, CONGENITAL
NF2	神经纤维瘤病	NEUROFIBROMATOSIS, TYPE II
EYA4	扩张型心肌病	CARDIOMYOPATHY, DILATED, 1J
NDUFA10	Leigh综合征	LEIGH SYNDROME
FBN1	马凡综合征	MARFAN SYNDROME
CNGA3	全色盲	ACHROMATOPSIA 2
CNGB3	全色盲	ACHROMATOPSIA 3
GNAT2	全色盲	ACHROMATOPSIA 4
BCS1L	Leigh综合征	LEIGH SYNDROME
SDHA	Leigh综合征	LEIGH SYNDROME
NDUFS4	Leigh综合征	LEIGH SYNDROME
NDUFAF2	Leigh综合征	LEIGH SYNDROME
NDUFA2	Leigh综合征	LEIGH SYNDROME
NDUFAF6	Leigh综合征	LEIGH SYNDROME
SURF1	Leigh综合征	LEIGH SYNDROME
NDUFS3	Leigh综合征	LEIGH SYNDROME
NDUFS8	Leigh综合征	LEIGH SYNDROME
FOXRED1	Leigh综合征	LEIGH SYNDROME
NDUFA9	Leigh综合征	LEIGH SYNDROME
NDUFA12	Leigh综合征	LEIGH SYNDROME
NDUFS7	Leigh综合征	LEIGH SYNDROME
ND2	Leigh综合征	LEIGH SYNDROME
COX10	Leigh综合征	LEIGH SYNDROME
ATP6	Leigh综合征	LEIGH SYNDROME
ND6	Leigh综合征	LEIGH SYNDROME
ND1	Leigh综合征	LEIGH SYNDROME
TRNV	Leigh综合征	LEIGH SYNDROME
ND3	Leigh综合征	LEIGH SYNDROME
ND5	Leigh综合征	LEIGH SYNDROME
KRT3	角膜营养不良	CORNEAL DYSTROPHY, MEESMANN
KRT12	角膜营养不良	CORNEAL DYSTROPHY, MEESMANN
TRNL1	糖尿病耳聋综合征	DIABETES-DEAFNESS SYNDROME, MATERNALLY TRANSMITTED
TRNE	糖尿病耳聋综合征	DIABETES-DEAFNESS SYNDROME, MATERNALLY TRANSMITTED
TRNK	糖尿病耳聋综合征	DIABETES-DEAFNESS SYNDROME, MATERNALLY TRANSMITTED
COL8A2	角膜营养不良	CORNEAL DYSTROPHY, FUCHS ENDOTHELIAL, 1
FLNA	FG综合征	FG SYNDROME 2
TRNS2	糖尿病耳聋综合征	DIABETES-DEAFNESS SYNDROME, MATERNALLY TRANSMITTED
TRNS1	糖尿病耳聋综合征	DIABETES-DEAFNESS SYNDROME, MATERNALLY TRANSMITTED
RB1	视网膜母细胞瘤	RETINOBLASTOMA
CDSN	皮肤剥脱综合征	PEELING SKIN SYNDROME 1
RS1	视网膜劈裂	RETINOSCHISIS 1, X-LINKED, JUVENILE
RP1	视网膜色素变性	RETINITIS PIGMENTOSA 1
CRTAP	成骨不全症	OSTEOGENESIS IMPERFECTA, TYPE VII
FIGLA	卵巢早衰	PREMATURE OVARIAN FAILURE 6
PLEKHG5	脊髓性肌萎缩症	SPINAL MUSCULAR ATROPHY, DISTAL, AUTOSOMAL RECESSIVE, 4
FGFR3	软骨发育不全	ACHONDROPLASIA
COL1A1	成骨不全症	OSTEOGENESIS IMPERFECTA, TYPE I
ABCA4	视网膜色素变性	RETINITIS PIGMENTOSA 19
COL1A1	成骨不全症	OSTEOGENESIS IMPERFECTA, TYPE II
COL1A1	成骨不全症	OSTEOGENESIS IMPERFECTA, TYPE IV
NR2E3	视网膜色素变性	RETINITIS PIGMENTOSA 37
NRL	视网膜色素变性	RETINITIS PIGMENTOSA 27
CNGA1	视网膜色素变性	RETINITIS PIGMENTOSA 49
NCSTN	反常性痤疮	ACNE INVERSA, FAMILIAL, 1
SAG	视网膜色素变性	RETINITIS PIGMENTOSA 47
CNGB1	视网膜色素变性	RETINITIS PIGMENTOSA 45
RGR	视网膜色素变性	RETINITIS PIGMENTOSA 44
RPE65	视网膜色素变性	RETINITIS PIGMENTOSA 20
UGT1A1	家族性非溶血性黄疸综合征	GILBERT SYNDROME
PDE6B	视网膜色素变性	RETINITIS PIGMENTOSA 40
USH2A	视网膜色素变性	RETINITIS PIGMENTOSA 39
PDE6A	视网膜色素变性	RETINITIS PIGMENTOSA 43
GUCA1B	视网膜色素变性	RETINITIS PIGMENTOSA 48
DHDDS	视网膜色素变性	RETINITIS PIGMENTOSA 59
MERTK	视网膜色素变性	RETINITIS PIGMENTOSA 38
PRPF6	视网膜色素变性	RETINITIS PIGMENTOSA 60
CLRN1	视网膜色素变性	RETINITIS PIGMENTOSA 61
MAK	视网膜色素变性	RETINITIS PIGMENTOSA 62
SQSTM1	佩吉特病	PAGET DISEASE OF BONE
TOPORS	视网膜色素变性	RETINITIS PIGMENTOSA 31
TNNC1	家族性肥厚型心肌病	CARDIOMYOPATHY, FAMILIAL HYPERTROPHIC, 13
TNNT2	家族性肥厚型心肌病	CARDIOMYOPATHY, FAMILIAL HYPERTROPHIC, 2
IDS	粘多糖贮积症	MUCOPOLYSACCHARIDOSIS, TYPE II
TPM1	家族性肥厚型心肌病	CARDIOMYOPATHY, FAMILIAL HYPERTROPHIC, 3
MYBPC3	家族性肥厚型心肌病	CARDIOMYOPATHY, FAMILIAL HYPERTROPHIC, 4
COL1A2	成骨不全症	OSTEOGENESIS IMPERFECTA, TYPE I
COL1A2	成骨不全症	OSTEOGENESIS IMPERFECTA, TYPE II
COL1A2	成骨不全症	OSTEOGENESIS IMPERFECTA, TYPE III
HFE	血色素沉着症	HEMOCHROMATOSIS, TYPE 1
HFE2	血色素沉着症	HEMOCHROMATOSIS, TYPE 2A
FKBP10	成骨不全症	OSTEOGENESIS IMPERFECTA, TYPE XI
SERPINH1	成骨不全症	OSTEOGENESIS IMPERFECTA, TYPE X
SP7	成骨不全症	OSTEOGENESIS IMPERFECTA, TYPE XII
SERPINF1	成骨不全症	OSTEOGENESIS IMPERFECTA, TYPE VI
MITF	白化病	ALBINISM, OCULAR, WITH SENSORINEURAL DEAFNESS
TYR	白化病	ALBINISM, OCULAR, WITH SENSORINEURAL DEAFNESS
FLG	鱼鳞病	ICHTHYOSIS VULGARIS
KRT2	鱼鳞病	ICHTHYOSIS, BULLOUS TYPE
SMN2	脊髓性肌萎缩症	SPINAL MUSCULAR ATROPHY, TYPE III
LIPN	鱼鳞病	ICHTHYOSIS, CONGENITAL, AUTOSOMAL RECESSIVE 8
KRT10	鱼鳞病	ICHTHYOSIS, CYCLIC, WITH EPIDERMOLYTIC HYPERKERATOSIS
GPR143	先天性眼球震颤	NYSTAGMUS 6, CONGENITAL, X-LINKED
MYOZ2	家族性肥厚型心肌病	CARDIOMYOPATHY, FAMILIAL HYPERTROPHIC, 16
JPH2	家族性肥厚型心肌病	CARDIOMYOPATHY, FAMILIAL HYPERTROPHIC, 17
CALR3	家族性肥厚型心肌病	CARDIOMYOPATHY, FAMILIAL HYPERTROPHIC, 19
PLN	家族性肥厚型心肌病	CARDIOMYOPATHY, FAMILIAL HYPERTROPHIC, 18
NEXN	家族性肥厚型心肌病	CARDIOMYOPATHY, FAMILIAL HYPERTROPHIC, 20
PKHD1	多囊肾病	POLYCYSTIC KIDNEY DISEASE, AUTOSOMAL RECESSIVE
ARX	X连锁智力低下	PARTINGTON X-LINKED MENTAL RETARDATION SYNDROME
ZNF41	X连锁智力低下	MENTAL RETARDATION, X-LINKED 89
G6PD	葡萄糖-6-磷酸脱氢酶缺乏症	Glucose-6-Phosphate Dehydrogenase deficiency
THPO	特发性血小板增多症	THROMBOCYTHEMIA 1
SOS1	努南综合征	NOONAN SYNDROME 4
RAF1	努南综合征	NOONAN SYNDROME 5
SUMO1	先天性唇腭裂	OROFACIAL CLEFT 10
TNFRSF13B	免疫球蛋白缺乏症	IMMUNOGLOBULIN A DEFICIENCY 2
PKD1	多囊肾病	POLYCYSTIC KIDNEY DISEASE 1
TTN	肌营养不良	TIBIAL MUSCULAR DYSTROPHY, TARDIVE
DYSF	肌营养不良	MIYOSHI MUSCULAR DYSTROPHY 1
PTPN11	努南综合征	NOONAN SYNDROME 1
DMD	肌营养不良	MUSCULAR DYSTROPHY, BECKER TYPE
BRAF	努南综合征	NOONAN SYNDROME 7
LMNA	埃-德二氏肌营养不良	EMERY-DREIFUSS MUSCULAR DYSTROPHY 2, AUTOSOMAL DOMINANT
CAPN3	肌营养不良	MUSCULAR DYSTROPHY, LIMB-GIRDLE, TYPE 2A
SGCB	肌营养不良	MUSCULAR DYSTROPHY, LIMB-GIRDLE, TYPE 2E
PLEC	肌营养不良	MUSCULAR DYSTROPHY, LIMB-GIRDLE, TYPE 2Q
TTN	肌营养不良	MUSCULAR DYSTROPHY, LIMB-GIRDLE, TYPE 2J
DYSF	肌营养不良	MUSCULAR DYSTROPHY, LIMB-GIRDLE, TYPE 2B
MYOT	肌营养不良	MUSCULAR DYSTROPHY, LIMB-GIRDLE, TYPE 1A
LMNA	肌营养不良	MUSCULAR DYSTROPHY, LIMB-GIRDLE, TYPE 1B
SGCG	肌营养不良	MUSCULAR DYSTROPHY, LIMB-GIRDLE, TYPE 2C
HMBS	卟啉病	PORPHYRIA, ACUTE INTERMITTENT
RAB39B	X连锁智力低下	MENTAL RETARDATION, X-LINKED 72
ZDHHC15	X连锁智力低下	MENTAL RETARDATION, X-LINKED 91
SOX3	X连锁智力低下	MENTAL RETARDATION, X-LINKED, WITH PANHYPOPITUITARISM
AFF2	X连锁智力低下	MENTAL RETARDATION, X-LINKED, ASSOCIATED WITH FRAGILE SITE FRAXE
AGTR2	X连锁智力低下	MENTAL RETARDATION, X-LINKED 88
ZNF674	X连锁智力低下	MENTAL RETARDATION, X-LINKED 92
DLG3	X连锁智力低下	MENTAL RETARDATION, X-LINKED 90
GDI1	X连锁智力低下	MENTAL RETARDATION, X-LINKED 41
RPS6KA3	X连锁智力低下	MENTAL RETARDATION, X-LINKED 19
SYP	X连锁智力低下	MENTAL RETARDATION, X-LINKED 96
ATP6AP2	X连锁智力低下	MENTAL RETARDATION, X-LINKED, SYNDROMIC, HEDERA TYPE
NF1	神经纤维瘤病	NEUROFIBROMATOSIS, TYPE I
FGFR3	软骨发育不全	HYPOCHONDROPLASIA
SMOC1	小眼畸形	MICROPHTHALMIA WITH LIMB ANOMALIES
LDB3	扩张型心肌病	CARDIOMYOPATHY, DILATED, 1C
PRSS56	孤立型小眼畸形	MICROPHTHALMIA, ISOLATED 6
TGM6	脊髓小脑性共济失调	SPINOCEREBELLAR ATAXIA 35
NOP56	脊髓小脑性共济失调	SPINOCEREBELLAR ATAXIA 36
ATXN1	脊髓小脑性共济失调	SPINOCEREBELLAR ATAXIA 1
RPL5	先天性纯红细胞再生障碍性贫血	DIAMOND-BLACKFAN ANEMIA 6
F13B	凝血因子缺乏症	FACTOR XIII, B SUBUNIT, DEFICIENCY OF
MCFD2	凝血因子缺乏症	FACTOR V AND FACTOR VIII, COMBINED DEFICIENCY OF, 2
F7	凝血因子缺乏症	FACTOR VII DEFICIENCY
FANCA	范可尼贫血	FANCONI ANEMIA, COMPLEMENTATION GROUP A
F12	凝血因子缺乏症	FACTOR XII DEFICIENCY
FANCE	范可尼贫血	FANCONI ANEMIA, COMPLEMENTATION GROUP E
FANCF	范可尼贫血	FANCONI ANEMIA, COMPLEMENTATION GROUP F
F10	凝血因子缺乏症	FACTOR X DEFICIENCY
SLX4	范可尼贫血	FANCONI ANEMIA, COMPLEMENTATION GROUP P
FANCB	范可尼贫血	FANCONI ANEMIA, COMPLEMENTATION GROUP B
FANCG	范可尼贫血	FANCONI ANEMIA, COMPLEMENTATION GROUP G
FANCL	范可尼贫血	FANCONI ANEMIA, COMPLEMENTATION GROUP L
VCL	扩张型心肌病	CARDIOMYOPATHY, DILATED, 1W
FANCM	范可尼贫血	FANCONI ANEMIA, COMPLEMENTATION GROUP M
COL3A1	Ehlers-Danlos综合征	EHLERS-DANLOS SYNDROME, HYPERMOBILITY TYPE
TNXB	Ehlers-Danlos综合征	EHLERS-DANLOS SYNDROME, HYPERMOBILITY TYPE
COL5A1	Ehlers-Danlos综合征	EHLERS-DANLOS SYNDROME, CLASSIC TYPE
COL1A2	Ehlers-Danlos综合征	EHLERS-DANLOS SYNDROME, TYPE VII, AUTOSOMAL DOMINANT
COL5A2	Ehlers-Danlos综合征	EHLERS-DANLOS SYNDROME, CLASSIC TYPE
COL1A1	Ehlers-Danlos综合征	EHLERS-DANLOS SYNDROME, TYPE VII, AUTOSOMAL DOMINANT
COL1A1	Ehlers-Danlos综合征	EHLERS-DANLOS SYNDROME, CLASSIC TYPE
COL5A1	Ehlers-Danlos综合征	EHLERS-DANLOS SYNDROME, TYPE II
COL5A2	Ehlers-Danlos综合征	EHLERS-DANLOS SYNDROME, TYPE II
B4GALT7	Ehlers-Danlos综合征	EHLERS-DANLOS SYNDROME, PROGEROID TYPE, 1
CHRM3	梨状腹综合征	ABDOMINAL MUSCLES, ABSENCE OF, WITH URINARY TRACT ABNORMALITY AND
ARHGAP31	Adams-Oliver综合征(先天性皮肤发育不良)	ADAMS-OLIVER SYNDROME 1
FGFR2	尖头多指并指畸形综合征	APERT SYNDROME
TWIST1	SAETHRE-CHOTZEN综合征	SAETHRE-CHOTZEN SYNDROME
FGFR2	SAETHRE-CHOTZEN综合征	SAETHRE-CHOTZEN SYNDROME
FGFR2	Pfeiffer综合征	PFEIFFER SYNDROME
FGFR1	Pfeiffer综合征	PFEIFFER SYNDROME
PRKAR1A	激素耐药的肢端骨发育不全	ACRODYSOSTOSIS 1 WITH OR WITHOUT HORMONE RESISTANCE
ATP2A2	疣状肢端角化病	ACROKERATOSIS VERRUCIFORMIS
AIP	生长激素型垂体腺瘤	PITUITARY ADENOMA, GROWTH HORMONE-SECRETING, 1
FBN1	肢端发育不良	ACROMICRIC DYSPLASIA
NOTCH2	Hajdu-Cheney综合征	HAJDU-CHENEY SYNDROME
SPATA16	生精障碍	SPERMATOGENIC FAILURE 6
ADA	复合型免疫缺陷	SEVERE COMBINED IMMUNODEFICIENCY, AUTOSOMAL RECESSIVE, T CELL-NEGATIVE,
ADSL	裂解酶缺乏症	ADENYLOSUCCINASE DEFICIENCY
TP63	ADULT综合征	ADULT SYNDROME
MITF	色素异常聋哑综合征	TIETZ SYNDROME
GNAS	假性甲状旁腺功能减退症	PSEUDOHYPOPARATHYROIDISM, TYPE IA
COL4A3	ALPORT综合征	ALPORT SYNDROME, AUTOSOMAL DOMINANT
DLX3	牙釉质发育不全	AMELOGENESIS IMPERFECTA, TYPE IV
GSN	淀粉样变性	AMYLOIDOSIS, FINNISH TYPE
FGA	淀粉样变性	AMYLOIDOSIS, FAMILIAL VISCERAL
APOA1	淀粉样变性	AMYLOIDOSIS, FAMILIAL VISCERAL
LYZ	淀粉样变性	AMYLOIDOSIS, FAMILIAL VISCERAL
TTR	淀粉样变性	AMYLOIDOSIS, HEREDITARY, TRANSTHYRETIN-RELATED
OSMR	淀粉样变性	AMYLOIDOSIS, PRIMARY LOCALIZED CUTANEOUS, 1
UBE3A	天使综合征	ANGELMAN SYNDROME
MECP2	天使综合征	ANGELMAN SYNDROME
CDKL5	天使综合征	ANGELMAN SYNDROME
PAX6	无虹膜	ANIRIDIA
PAX2	无虹膜	ANIRIDIA
TP63	睑缘粘连-外胚层发育不全-裂综合征	ANKYLOBLEPHARON-ECTODERMAL DEFECTS-CLEFT LIP/PALATE
MSX1	选择性牙齿发育不全	TOOTH AGENESIS, SELECTIVE, 1
PITX3	前段间质发育不全	ANTERIOR SEGMENT MESENCHYMAL DYSGENESIS
FOXE3	前段间质发育不全	ANTERIOR SEGMENT MESENCHYMAL DYSGENESIS
SALL1	无肛畸形综合征	TOWNES-BROCKS SYNDROME
TGFB3	致心律失常性右室心肌病	ARRHYTHMOGENIC RIGHT VENTRICULAR DYSPLASIA, FAMILIAL, 1
TPM2	远端关节弯曲	ARTHROGRYPOSIS, DISTAL, TYPE 1A
COL2A1	斯蒂克勒综合征	STICKLER SYNDROME, TYPE I
CACNA1A	周期性共济失调	EPISODIC ATAXIA, TYPE 2
FLNB	骨发育不全症	ATELOSTEOGENESIS, TYPE I
NKX2-5	房间隔缺损	ATRIAL SEPTAL DEFECT 7 WITH OR WITHOUT ATRIOVENTRICULAR CONDUCTION
TEAD1	Sveinsson脉络膜视网膜萎缩	SVEINSSON CHORIORETINAL ATROPHY
PTCH1	基底细胞痣综合征	BASAL CELL NEVUS SYNDROME
SUFU	基底细胞痣综合征	BASAL CELL NEVUS SYNDROME
PTCH2	基底细胞痣综合征	BASAL CELL NEVUS SYNDROME
NOTCH1	主动脉瓣畸形	AORTIC VALVE DISEASE 1
FOXL2	睑裂狭小,倒转型内眦赘皮和上睑下垂综合征	BLEPHAROPHIMOSIS, PTOSIS, AND EPICANTHUS INVERSUS
FLNB	骨发育不良	BOOMERANG DYSPLASIA
IHH	短指症	BRACHYDACTYLY, TYPE A1
BMPR1B	短指症	BRACHYDACTYLY, TYPE A2
GDF5	短指症	BRACHYDACTYLY, TYPE A2
ROR2	短指症	BRACHYDACTYLY, TYPE B1
GDF5	短指症	BRACHYDACTYLY, TYPE C
TRPV4	短躯干症	BRACHYOLMIA TYPE 3
TFAP2A	鳃裂眼面综合征	BRANCHIOOCULOFACIAL SYNDROME
EYA1	鳃-耳-肾综合征	BRANCHIOOTORENAL SYNDROME 1
KRT10	表皮松解性角化过度病	EPIDERMOLYTIC HYPERKERATOSIS
KRT1	表皮松解性角化过度病	EPIDERMOLYTIC HYPERKERATOSIS
SCN5A	进行性家族性心脏传导阻滞	PROGRESSIVE FAMILIAL HEART BLOCK, TYPE IA
COL1A1	卡菲病	CAFFEY DISEASE
SOX9	躯干发育异常	CAMPOMELIC DYSPLASIA
BRAF	心面皮肤综合征	CARDIOFACIOCUTANEOUS SYNDROME 1
MAP2K1	心面皮肤综合征	CARDIOFACIOCUTANEOUS SYNDROME 1
MAP2K2	心面皮肤综合征	CARDIOFACIOCUTANEOUS SYNDROME 1
KRAS	心面皮肤综合征	CARDIOFACIOCUTANEOUS SYNDROME 1
TNNI3	家族性限制性心肌病	CARDIOMYOPATHY, FAMILIAL RESTRICTIVE, 1
BCMO1	高胡萝卜素血症和维生素A缺乏症	HYPERCAROTENEMIA AND VITAMIN A DEFICIENCY, AUTOSOMAL DOMINANT
SDHB	副神经节瘤	PARAGANGLIOMAS 4
TTR	腕管综合征	CARPAL TUNNEL SYNDROME
GJA8	伴有小角膜的白内障综合征	CATARACT-MICROCORNEA SYNDROME
GJA8	白内障	CATARACT 1, MULTIPLE TYPES
HSF4	白内障	CATARACT 5, MULTIPLE TYPES
KRIT1	脑海绵状血管畸形	CEREBRAL CAVERNOUS MALFORMATIONS
ITGB2	白细胞粘附缺陷	LEUKOCYTE ADHESION DEFICIENCY, TYPE I
RYR1	中央轴空病/微轴空病	CENTRAL CORE DISEASE OF MUSCLE
ITM2B	脑淀粉样血管病	CEREBRAL AMYLOID ANGIOPATHY, ITM2B-RELATED, 2
NSD1	Sotos综合征	SOTOS SYNDROME 1
GDF6	Klippel-Feil综合征(短颈畸形综合征)	KLIPPEL-FEIL SYNDROME 1, AUTOSOMAL DOMINANT
MPZ	腓骨肌萎缩症	CHARCOT-MARIE-TOOTH DISEASE, DEMYELINATING, TYPE 1B
KIF1B	腓骨肌萎缩症	CHARCOT-MARIE-TOOTH DISEASE, AXONAL, TYPE 2A1
PMP22	腓骨肌萎缩症	CHARCOT-MARIE-TOOTH DISEASE, DEMYELINATING, TYPE 1A
PMP22	腓骨肌萎缩症	CHARCOT-MARIE-TOOTH DISEASE AND DEAFNESS
SH3BP2	家族性巨颌症	CHERUBISM
JAG1	Alagille综合征	ALAGILLE SYNDROME 1
ANKH	关节软骨钙质沉着病	CHONDROCALCINOSIS 2
NKX2-1	遗传性良性舞蹈症	CHOREA, BENIGN HEREDITARY
IRF6	VanderWoude综合征	VAN DER WOUDE SYNDROME 1
IRF6	腘翼状胬肉综合征	POPLITEAL PTERYGIUM SYNDROME
SATB2	腭裂	119540 CLEFT PALATE, ISOLATED
RUNX2	锁骨颅骨发育不全	CLEIDOCRANIAL DYSPLASIA
PITX1	先天性马蹄内翻足	CLUBFOOT, CONGENITAL, WITH OR WITHOUT DEFICIENCY OF LONG BONES AND/OR
HPGD	遗传性杵状指	DIGITAL CLUBBING, ISOLATED CONGENITAL
NLRP3	家族性寒冷性荨麻疹	FAMILIAL COLD AUTOINFLAMMATORY SYNDROME 1
PAX2	Papillorenal综合征	PAPILLORENAL SYNDROME
MSH2	大肠癌	LYNCH SYNDROME I
CRX	锥杆营养不良	CONE-ROD DYSTROPHY 2
FBN2	远端关节弯曲	ARTHROGRYPOSIS, DISTAL, TYPE 9
KCNQ2	癫痫	SEIZURES, BENIGN FAMILIAL NEONATAL, 1
KCNQ3	癫痫	SEIZURES, BENIGN FAMILIAL NEONATAL, 2
UBIAD1	角膜营养不良	SCHNYDER CORNEAL DYSTROPHY
TGFBI	角膜营养不良	CORNEAL DYSTROPHY, EPITHELIAL BASEMENT MEMBRANE
PIKFYVE	角膜营养不良	CORNEAL DYSTROPHY, FLECK
TGFBI	角膜营养不良	CORNEAL DYSTROPHY, GROENOUW TYPE I
VSX1	角膜营养不良	CORNEAL DYSTROPHY, POSTERIOR POLYMORPHOUS, 1
TGFBI	角膜营养不良	CORNEAL DYSTROPHY, LATTICE TYPE I
NIPBL	德朗热综合征	CORNELIA DE LANGE SYNDROME 1
SOST	颅骨骨干发育异常	CRANIODIAPHYSEAL DYSPLASIA, AUTOSOMAL DOMINANT
PAX3	颅面-耳聋-手综合征	CRANIOFACIAL-DEAFNESS-HAND SYNDROME
ANKH	颅骨干骺端发育不良	CRANIOMETAPHYSEAL DYSPLASIA, AUTOSOMAL DOMINANT
TWIST1	颅缝早闭	CRANIOSYNOSTOSIS 1
FGFR2	Jackson-Weiss综合征	JACKSON-WEISS SYNDROME
PRNP	克雅二氏病	CREUTZFELDT-JAKOB DISEASE
FGFR2	Crouzon综合征	CROUZON SYNDROME
FGFR2	环纹皮肤综合征	BEARE-STEVENSON CUTIS GYRATA SYNDROME
UQCRB	线粒体复合物缺乏症	MITOCHONDRIAL COMPLEX III DEFICIENCY, NUCLEAR TYPE 1
BCS1L	线粒体复合物缺乏症	MITOCHONDRIAL COMPLEX III DEFICIENCY, NUCLEAR TYPE 1
TTC19	线粒体复合物缺乏症	MITOCHONDRIAL COMPLEX III DEFICIENCY, NUCLEAR TYPE 1
UQCRQ	线粒体复合物缺乏症	MITOCHONDRIAL COMPLEX III DEFICIENCY, NUCLEAR TYPE 1
ATP2A2	达里耶病(毛囊角化病)	DARIER-WHITE DISEASE
GJB2	Vohwinkel综合征	DEAFNESS, CONGENITAL, WITH KERATOPACHYDERMIA AND CONSTRICTIONS OF
DIAPH1	先天性耳聋	DEAFNESS, AUTOSOMAL DOMINANT 1
OPA1	视神经萎缩	OPTIC ATROPHY WITH OR WITHOUT DEAFNESS, OPHTHALMOPLEGIA, MYOPATHY,
NOTCH3	脑白质病	CEREBRAL ARTERIOPATHY, AUTOSOMAL DOMINANT, WITH SUBCORTICAL INFARCTS
PTH1R	牙齿发育障碍	FAILURE OF TOOTH ERUPTION, PRIMARY
SMOC2	牙本质发育不良	DENTIN DYSPLASIA, TYPE I
DSPP	牙本质发育不良	DENTIN DYSPLASIA, TYPE II
DSPP	牙本质发育不良	DENTINOGENESIS IMPERFECTA 1
KRT14	网状色素性皮病	DERMATOPATHIA PIGMENTOSA RETICULARIS
AVP	尿崩症	DIABETES INSIPIDUS, NEUROHYPOPHYSEAL
AQP2	尿崩症	DIABETES INSIPIDUS, NEPHROGENIC, AUTOSOMAL
HNF4A	青年发病的成年型糖尿病	MATURITY-ONSET DIABETES OF THE YOUNG, TYPE 1
GCK	青年发病的成年型糖尿病	MATURITY-ONSET DIABETES OF THE YOUNG, TYPE 2
EFEMP1	视网膜营养不良	DOYNE HONEYCOMB RETINAL DYSTROPHY
SHOX	Leri-Weill软骨骨生成障碍	LERI-WEILL DYSCHONDROSTEOSIS
ADAR	遗传性对称性色素异常病	DYSCHROMATOSIS SYMMETRICA HEREDITARIA
TERC	先天性角化不良	DYSKERATOSIS CONGENITA, AUTOSOMAL DOMINANT 1
PRRT2	发作性运动诱发性运动障碍	EPISODIC KINESIGENIC DYSKINESIA 1
GCH1	肌张力障碍	DYSTONIA, DOPA-RESPONSIVE
ATP1A3	肌张力障碍	DYSTONIA 12
TP63	Rapp-Hodgkin综合征	RAPP-HODGKIN SYNDROME
GJB6	发汗性外胚层发育不良	CLOUSTON SYNDROME
FBN1	晶状体异位	ECTOPIA LENTIS 1, ISOLATED, AUTOSOMAL DOMINANT
SPTA1	椭圆形红细胞增多症	ELLIPTOCYTOSIS 2
CDKN1C	Beckwith-Wiedemann症候群	BECKWITH-WIEDEMANN SYNDROME
H19	Beckwith-Wiedemann症候群	BECKWITH-WIEDEMANN SYNDROME
NSD1	Beckwith-Wiedemann症候群	BECKWITH-WIEDEMANN SYNDROME
FAM83H	牙釉质发育不全	AMELOGENESIS IMPERFECTA, TYPE III
MEN1	多发性内分泌腺瘤病	MULTIPLE ENDOCRINE NEOPLASIA, TYPE I
TGFB1	骨发育不良	CAMURATI-ENGELMANN DISEASE
COL7A1	新生儿暂时性大疱性皮肤松解	TRANSIENT BULLOUS DERMOLYSIS OF THE NEWBORN
COL7A1	大疱性表皮松解症	EPIDERMOLYSIS BULLOSA DYSTROPHICA, AUTOSOMAL DOMINANT
KRT14	单纯型大疱性表皮松解症	EPIDERMOLYSIS BULLOSA SIMPLEX, DOWLING-MEARA TYPE
KRT5	单纯型大疱性表皮松解症	EPIDERMOLYSIS BULLOSA SIMPLEX, DOWLING-MEARA TYPE
KRT14	单纯型大疱性表皮松解症	EPIDERMOLYSIS BULLOSA SIMPLEX, LOCALIZED
KRT5	单纯型大疱性表皮松解症	EPIDERMOLYSIS BULLOSA SIMPLEX, LOCALIZED
ITGB4	单纯型大疱性表皮松解症	EPIDERMOLYSIS BULLOSA SIMPLEX, LOCALIZED
KRT14	单纯型大疱性表皮松解症	EPIDERMOLYSIS BULLOSA SIMPLEX, GENERALIZED
KRT5	单纯型大疱性表皮松解症	EPIDERMOLYSIS BULLOSA SIMPLEX, GENERALIZED
COL7A1	大疱性表皮松解症	EPIDERMOLYSIS BULLOSA WITH CONGENITAL LOCALIZED ABSENCE OF SKIN AND
COMP	多发性骨骺发育不良	EPIPHYSEAL DYSPLASIA, MULTIPLE, 1
COL2A1	多发性骨骺发育不良	EPIPHYSEAL DYSPLASIA, MULTIPLE, WITH MYOPIA AND CONDUCTIVE DEAFNESS
CYLD	家族性圆柱瘤	CYLINDROMATOSIS, FAMILIAL
MYH11	主动脉瘤	AORTIC ANEURYSM, FAMILIAL THORACIC 4
SCN9A	原发性红斑性肢痛病	ERYTHERMALGIA, PRIMARY
EPOR	家族性红细胞增多症	ERYTHROCYTOSIS, FAMILIAL, 1
GJB3	可变性红斑皮肤角化病	ERYTHROKERATODERMIA VARIABILIS ET PROGRESSIVA
GJB4	可变性红斑皮肤角化病	ERYTHROKERATODERMIA VARIABILIS ET PROGRESSIVA
ERCC6	Cockayne综合征	COCKAYNE SYNDROME B
EXT1	多发性外生骨疣	EXOSTOSES, MULTIPLE, TYPE I
EXT2	多发性外生骨疣	EXOSTOSES, MULTIPLE, TYPE II
FZD4	渗出性玻璃体视网膜病	EXUDATIVE VITREORETINOPATHY 1
ACVR1	进行性骨化性纤维发育不良	FIBRODYSPLASIA OSSIFICANS PROGRESSIVA
APC	遗传性硬纤维瘤	DESMOID DISEASE, HEREDITARY
SOS1	牙龈纤维瘤病	FIBROMATOSIS, GINGIVAL, 1
KIF21A	先天性眼外肌纤维化	FIBROSIS OF EXTRAOCULAR MUSCLES, CONGENITAL, 1
ARID1B	COFFIN-SIRIS综合征	COFFIN-SIRIS SYNDROME
ARID1A	COFFIN-SIRIS综合征	COFFIN-SIRIS SYNDROME
LCAT	鱼眼病	FISH-EYE DISEASE
SRCAP	Floating-Harbor综合征	FLOATING-HARBOR SYNDROME
PAX6	先天性白内障	FOVEAL HYPOPLASIA 1
WT1	Frasier综合征	FRASIER SYNDROME
ALX3	额鼻发育不良	FRONTONASAL DYSPLASIA 1
RDH5	白点状眼底	FUNDUS ALBIPUNCTATUS
PRPH2	白点状眼底	FUNDUS ALBIPUNCTATUS
RLBP1	白点状眼底	FUNDUS ALBIPUNCTATUS
TIMP3	Sorsby眼底营养不良	FUNDUS DYSTROPHY, PSEUDOINFLAMMATORY, OF SORSBY
CDH1	胃癌	GASTRIC CANCER, HEREDITARY DIFFUSE
PRNP	Gerstmann-Straussler病	GERSTMANN-STRAUSSLER DISEASE
PITX2	虹膜角膜发育不良	IRIDOGONIODYSGENESIS, TYPE 2
OPTN	开角型青光眼	GLAUCOMA, PRIMARY OPEN ANGLE
HNF1B	青年发病的成年型糖尿病	RENAL CYSTS AND DIABETES SYNDROME
GLMN	球细胞静脉畸形	GLOMUVENOUS MALFORMATIONS
NBEAL2	灰色血小板综合征	GRAY PLATELET SYNDROME
SMAD4	Myhre综合征	MYHRE SYNDROME
HOXA13	手足生殖器综合征	HAND-FOOT-GENITAL SYNDROME
HPD	乙酸尿	HAWKINSINURIA
COL4A3	良性家族性血尿	HEMATURIA, BENIGN FAMILIAL
ATP1A2	偏瘫性偏头痛	MIGRAINE, FAMILIAL HEMIPLEGIC, 1
CACNA1A	偏瘫性偏头痛	MIGRAINE, FAMILIAL HEMIPLEGIC, 1
TNFRSF1A	家族性周期热	PERIODIC FEVER, FAMILIAL, AUTOSOMAL DOMINANT
TBX5	Holt-Oram综合征	HOLT-ORAM SYNDROME
SHH	前脑无裂畸形	HOLOPROSENCEPHALY 3
TGIF1	前脑无裂畸形	HOLOPROSENCEPHALY 4
CHST3	脊椎骨骺发育不良	SPONDYLOEPIPHYSEAL DYSPLASIA WITH CONGENITAL JOINT DISLOCATIONS
VCAN	Wagner综合征	WAGNER VITREORETINOPATHY
CA12	高氯汗症	HYPERCHLORHIDROSIS, ISOLATED
CYP24A1	小儿高钙血症	HYPERCALCEMIA, INFANTILE
ABCA1	高胆固醇血症	HYPERCHOLESTEROLEMIA, FAMILIAL
KRT9	掌跖角化病	PALMOPLANTAR KERATODERMA, EPIDERMOLYTIC
KRT1	掌跖角化病	PALMOPLANTAR KERATODERMA, EPIDERMOLYTIC
APOA5	高脂蛋白血症	HYPERLIPOPROTEINEMIA, TYPE V
KITLG	家族性渐进性色素沉着	HYPERPIGMENTATION WITH OR WITHOUT HYPOPIGMENTATION, FAMILIAL PROGRESSIVE
TTR	运甲状腺素蛋白功能失常甲状腺机能正常的血甲状腺素过多	HYPERTHYROXINEMIA, DYSTRANSTHYRETINEMIC
PRX	Dejerine-Sottas病肥大性神经病	HYPERTROPHIC NEUROPATHY OF DEJERINE-SOTTAS
MPZ	Dejerine-Sottas病肥大性神经病	HYPERTROPHIC NEUROPATHY OF DEJERINE-SOTTAS
PMP22	Dejerine-Sottas病肥大性神经病	HYPERTROPHIC NEUROPATHY OF DEJERINE-SOTTAS
EGR2	Dejerine-Sottas病肥大性神经病	HYPERTROPHIC NEUROPATHY OF DEJERINE-SOTTAS
CASR	家族性低尿钙高钙血症	HYPOCALCIURIC HYPERCALCEMIA, FAMILIAL, TYPE I
GNRHR	低促性腺激素性性腺功能减退症	HYPOGONADOTROPIC HYPOGONADISM 7 WITH OR WITHOUT ANOSMIA
GCM2	家族性孤立性甲状旁腺功能减退症	HYPOPARATHYROIDISM, FAMILIAL ISOLATED
CASR	家族性孤立性甲状旁腺功能减退症	HYPOPARATHYROIDISM, FAMILIAL ISOLATED
PTH	家族性孤立性甲状旁腺功能减退症	HYPOPARATHYROIDISM, FAMILIAL ISOLATED
GATA3	甲状旁腺功能减退症,感音神经性聋和肾发育不良综合征	HYPOPARATHYROIDISM, SENSORINEURAL DEAFNESS, AND RENAL DISEASE
GLI3	Pallister-Hall综合征	PALLISTER-HALL SYNDROME
CDSN	单一性头皮稀毛症	HYPOTRICHOSIS 2
KRT1	鱼鳞病	ICHTHYOSIS HYSTRIX, CURTH-MACKLIN TYPE
SHH	单体中上颌骨中央切牙	SOLITARY MEDIAN MAXILLARY CENTRAL INCISOR
SALL4	Ivic综合征	IVIC SYNDROME
TBX4	小髌骨综合征	SMALL PATELLA SYNDROME
MLL2	Kabuki综合征	KABUKI SYNDROME 1
FGFR1	Kallmann综合征	HYPOGONADOTROPIC HYPOGONADISM 2 WITH OR WITHOUT ANOSMIA
ANKRD11	KBG综合征	KBG SYNDROME
PAX6	遗传性角膜炎	KERATITIS, HEREDITARY
GJB2	鱼鳞病	KERATITIS-ICHTHYOSIS-DEAFNESS SYNDROME, AUTOSOMAL DOMINANT
VSX1	圆锥形角膜	KERATOCONUS 1
GJB2	掌跖角化症	KERATODERMA, PALMOPLANTAR, WITH DEAFNESS
RHBDF2	掌跖角化症食管癌综合征	TYLOSIS WITH ESOPHAGEAL CANCER
DSG1	掌跖角化病	PALMOPLANTAR KERATODERMA I, STRIATE, FOCAL, OR DIFFUSE
PAX3	瓦登伯革氏症候群	WAARDENBURG SYNDROME, TYPE 3
GJB2	指拐垫,白甲病,和感觉神经性聋	KNUCKLE PADS, LEUKONYCHIA, AND SENSORINEURAL DEAFNESS
GLRA1	过度惊骇	HYPEREKPLEXIA, HEREDITARY 1
FGFR2	Levy-Hollister综合征	LACRIMOAURICULODENTODIGITAL SYNDROME
FGF10	Levy-Hollister综合征	LACRIMOAURICULODENTODIGITAL SYNDROME
FGFR3	Levy-Hollister综合征	LACRIMOAURICULODENTODIGITAL SYNDROME
FLNB	Larsen综合征	LARSEN SYNDROME
WNT10A	选择性牙齿发育不全	TOOTH AGENESIS, SELECTIVE, 4
COL2A1	累-卡-佩三氏病	LEGG-CALVE-PERTHES DISEASE
FH	遗传性平滑肌瘤病和肾细胞癌	HEREDITARY LEIOMYOMATOSIS AND RENAL CELL CANCER
PTPN11	豹皮综合征	LEOPARD SYNDROME 1
COL2A1	Platyspondylic致死的骨骼发育异常	PLATYSPONDYLIC LETHAL SKELETAL DYSPLASIA, TORRANCE TYPE
PLCD1	非综合征性先天性指甲障碍	NAIL DISORDER, NONSYNDROMIC CONGENITAL, 3
TP53	李-佛美尼综合征	LI-FRAUMENI SYNDROME 1
LMNA	局部脂肪营养不良	LIPODYSTROPHY, FAMILIAL PARTIAL, TYPE 2
KIF11	小头畸形	MICROCEPHALY WITH OR WITHOUT CHORIORETINOPATHY, LYMPHEDEMA, OR MENTAL
FLT4	遗传性淋巴水肿	LYMPHEDEMA, HEREDITARY, IA
FOXC2	淋巴水肿-重睫综合征	LYMPHEDEMA-DISTICHIASIS SYNDROME
PTEN	大头畸形,多发性脂肪瘤和血管瘤	BANNAYAN-RILEY-RUVALCABA SYNDROME
BMPR1A	大头畸形,多发性脂肪瘤和血管瘤	BANNAYAN-RILEY-RUVALCABA SYNDROME
MYH9	Fechtner综合征	FECHTNER SYNDROME
MYH9	Epstein综合征	EPSTEIN SYNDROME
BEST1	黄斑营养不良	MACULAR DYSTROPHY, VITELLIFORM, 2
FXYD2	低镁血症	HYPOMAGNESEMIA 2, RENAL
SF3B4	面骨发育不全	ACROFACIAL DYSOSTOSIS 1, NAGER TYPE
TCOF1	下颌面骨发育不全	TREACHER COLLINS SYNDROME 1
COL11A1	Marshall综合征	MARSHALL SYNDROME
MYH9	May-Hegglin异常	MAY-HEGGLIN ANOMALY
RET	家族性甲状腺髓样癌	THYROID CARCINOMA, FAMILIAL MEDULLARY
CDKN2A	黑素瘤-星形细胞瘤综合征	MELANOMA-ASTROCYTOMA SYNDROME
PTPN11	混合性软骨瘤病	METACHONDROMATOSIS
PTH1R	干骺端软骨发育异常	METAPHYSEAL CHONDRODYSPLASIA, JANSEN TYPE
COL10A1	干骺端软骨发育不良	METAPHYSEAL CHONDRODYSPLASIA, SCHMID TYPE
TRPV4	骨发育不良	METATROPIC DYSPLASIA
COL2A1	Kniest发育不良	KNIEST DYSPLASIA
SIX3	前脑无裂畸形	HOLOPROSENCEPHALY 2
DCC	先天性镜像运动	MIRROR MOVEMENTS 1
POLG	进行性外眼肌麻痹	PROGRESSIVE EXTERNAL OPHTHALMOPLEGIA WITH MITOCHONDRIAL DNA DELETIONS,
KRT86	念珠形发	MONILETHRIX
KRT81	念珠形发	MONILETHRIX
KRT83	念珠形发	MONILETHRIX
MSH2	Muir-Torre综合征	MUIR-TORRE SYNDROME
MLH1	Muir-Torre综合征	MUIR-TORRE SYNDROME
MSH6	Muir-Torre综合征	MUIR-TORRE SYNDROME
WNT4	苗勒氏管发育不全和高雄激素血症	MULLERIAN APLASIA AND HYPERANDROGENISM
PTEN	Cowden综合征	COWDEN SYNDROME 1
HSPB8	远端遗传性运动神经元病	NEURONOPATHY, DISTAL HEREDITARY MOTOR, TYPE IIA
DYNC1H1	脊髓性肌萎缩症	SPINAL MUSCULAR ATROPHY, LOWER EXTREMITY-PREDOMINANT, 1, AUTOSOMAL
COL6A2	Bethlem肌病	BETHLEM MYOPATHY
COL6A3	Bethlem肌病	BETHLEM MYOPATHY
COL6A1	Bethlem肌病	BETHLEM MYOPATHY
ASAH1	脊髓性肌萎缩症	SPINAL MUSCULAR ATROPHY WITH PROGRESSIVE MYOCLONIC EPILEPSY
KCNA1	周期性共济失调	EPISODIC ATAXIA, TYPE 1
DNM2	中央核性肌病	MYOPATHY, CENTRONUCLEAR, 1
MYH7	远端肌病	MYOPATHY, DISTAL, 1
CLCN1	肌强直症	MYOTONIA CONGENITA, AUTOSOMAL DOMINANT
PRKAR1A	Carney综合征	CARNEY COMPLEX, TYPE 1
KRT14	纳尔格力综合征	NAEGELI SYNDROME
LMX1B	指甲髌骨综合征	NAIL-PATELLA SYNDROME
ACTA1	线状体肌病	NEMALINE MYOPATHY 3
UMOD	高尿酸血症肾病	HYPERURICEMIC NEPHROPATHY, FAMILIAL JUVENILE, 1
NF1	神经纤维瘤病	NEUROFIBROMATOSIS, FAMILIAL SPINAL
RET	多发性内分泌腺瘤病	MULTIPLE ENDOCRINE NEOPLASIA, TYPE IIB
DNAJC5	神经元蜡样质脂褐质沉积症	CEROID LIPOFUSCINOSIS, NEURONAL, 4B, AUTOSOMAL DOMINANT
SPTLC1	感觉自主神经病	NEUROPATHY, HEREDITARY SENSORY AND AUTONOMIC, TYPE IA
PMP22	感觉自主神经病	NEUROPATHY, HEREDITARY, WITH LIABILITY TO PRESSURE PALSIES
ELANE	中性粒细胞减少症	CYCLIC NEUTROPENIA
CSF3R	遗传性中性白细胞增多症	NEUTROPHILIA, HEREDITARY
PDE6B	先天性静止性夜盲症	NIGHT BLINDNESS, CONGENITAL STATIONARY, AUTOSOMAL DOMINANT 2
HCN4	病态窦房结综合征	SICK SINUS SYNDROME 2, AUTOSOMAL DOMINANT
GJA1	眼齿指发育不良	OCULODENTODIGITAL DYSPLASIA
MYCN	Feingold综合征	FEINGOLD SYNDROME 1
PABPN1	眼咽型肌营养不良	OCULOPHARYNGEAL MUSCULAR DYSTROPHY
OPA3	视神经萎缩	OPTIC ATROPHY 3, AUTOSOMAL DOMINANT
OPA1	视神经萎缩	OPTIC ATROPHY 1
PAX6	双侧视神经发育不全	OPTIC NERVE HYPOPLASIA, BILATERAL
ACAN	分离性骨软骨炎,矮小身材,早发性骨关节炎	OSTEOCHONDRITIS DISSECANS, SHORT STATURE, AND EARLY-ONSET OSTEOARTHRITIS
FGFR1	Osteoglophonic发育异常	OSTEOGLOPHONIC DYSPLASIA
ANO5	Gnathodiaphyseal发育不良	GNATHODIAPHYSEAL DYSPLASIA
MAFB	特发性指(趾)肢端溶骨症	MULTICENTRIC CARPOTARSAL OSTEOLYSIS SYNDROME
GNAS	进行性骨性错生	OSSEOUS HETEROPLASIA, PROGRESSIVE
CLCN7	骨硬化病	OSTEOPETROSIS, AUTOSOMAL DOMINANT 2
LEMD3	Buschke-Ollendorff综合征	BUSCHKE-OLLENDORFF SYNDROME
EYA1	OTOFACIOCERVICAL综合征	OTOFACIOCERVICAL SYNDROME 1
KRT6A	先天性厚甲症	PACHYONYCHIA CONGENITA 1
KRT16	先天性厚甲症	PACHYONYCHIA CONGENITA 1
KRT17	先天性厚甲症	PACHYONYCHIA CONGENITA 2
KRT6B	先天性厚甲症	PACHYONYCHIA CONGENITA 2
VCP	包涵体肌病	INCLUSION BODY MYOPATHY WITH EARLY-ONSET PAGET DISEASE WITH OR WITHOUT
SCN9A	阵发性极度疼痛症	PAROXYSMAL EXTREME PAIN DISORDER
CFTR	胰腺炎	PANCREATITIS, HEREDITARY
PRSS1	胰腺炎	PANCREATITIS, HEREDITARY
CASR	胰腺炎	PANCREATITIS, HEREDITARY
SDHD	副神经节瘤	PARAGANGLIOMAS 1
SCN4A	肌强直症	PARAMYOTONIA CONGENITA OF VON EULENBURG
MSX2	顶骨发育不全	PARIETAL FORAMINA
ALX4	顶骨发育不全	PARIETAL FORAMINA
MSX2	顶骨发育不全	PARIETAL FORAMINA WITH CLEIDOCRANIAL DYSPLASIA
DCTN1	帕金森病伴肺泡通气不足和精神抑郁	PERRY SYNDROME
TFAP2B	动脉导管未闭	CHAR SYNDROME
PRPH2	视网膜色素上皮细胞蝴蝶形营养不良	MACULAR DYSTROPHY, PATTERNED, 1
LBR	Pelger-Huet异常	PELGER-HUET ANOMALY
ATP2C1	良性慢性天疱疮	BENIGN CHRONIC PEMPHIGUS
PEPD	水解酶缺乏症	PROLIDASE DEFICIENCY
KCNJ2	长Q-T间期综合征	ANDERSEN CARDIODYSRHYTHMIC PERIODIC PARALYSIS
CACNA1S	低钾性周期性麻痹	HYPOKALEMIC PERIODIC PARALYSIS, TYPE 1
SCN4A	高血钾性周期性麻痹	HYPERKALEMIC PERIODIC PARALYSIS
CTSC	牙周炎	PERIODONTITIS, AGGRESSIVE, 1
RET	多发性内分泌腺瘤病	MULTIPLE ENDOCRINE NEOPLASIA, TYPE IIA
KIT	斑驳病	PIEBALD TRAIT
CRB1	色素性静脉旁脉络膜视网膜萎缩	PIGMENTED PARAVENOUS CHORIORETINAL ATROPHY
GH1	单一性生长素缺乏症	ISOLATED GROWTH HORMONE DEFICIENCY, TYPE II
CARD14	毛发红糠疹	PITYRIASIS RUBRA PILARIS
FLCN	原发性自发性气胸	PNEUMOTHORAX, PRIMARY SPONTANEOUS
FERMT1	KINDLER综合症	KINDLER SYNDROME
SEC63	多囊性肝病	POLYCYSTIC LIVER DISEASE
PRKCSH	多囊性肝病	POLYCYSTIC LIVER DISEASE
GLI3	轴后多发性短指	POLYDACTYLY, POSTAXIAL, TYPE A1
GLI3	轴前多指畸形	POLYDACTYLY, PREAXIAL IV
TNFRSF11A	遗传性膨胀性多骨溶骨性发育不良	FAMILIAL EXPANSILE OSTEOLYSIS
SMAD4	息肉病综合征	JUVENILE POLYPOSIS SYNDROME
BMPR1A	息肉病综合征	JUVENILE POLYPOSIS SYNDROME
APC	家族性腺瘤性息肉病	FAMILIAL ADENOMATOUS POLYPOSIS 1
GLI3	Greig头多指综合征	GREIG CEPHALOPOLYSYNDACTYLY SYNDROME
COL4A1	家族性孔洞脑	PORENCEPHALY 1
SART3	弥漫性浅表性光敏性汗孔角化症	POROKERATOSIS 3, DISSEMINATED SUPERFICIAL ACTINIC TYPE
LHCGR	性早熟	PRECOCIOUS PUBERTY, MALE-LIMITED
BUB1B	未成熟染色单体分离症	PREMATURE CHROMATID SEPARATION TRAIT
PROC	易栓症	THROMBOPHILIA DUE TO PROTEIN C DEFICIENCY, AUTOSOMAL DOMINANT
SCNN1G	利德尔综合征	LIDDLE SYNDROME
SCNN1B	利德尔综合征	LIDDLE SYNDROME
NR3C2	假性醛固酮过少症	PSEUDOHYPOALDOSTERONISM, TYPE I, AUTOSOMAL DOMINANT
SLC4A1	肾小管酸中毒	RENAL TUBULAR ACIDOSIS, DISTAL, AUTOSOMAL DOMINANT
WNT5A	Robinow综合征	ROBINOW SYNDROME, AUTOSOMAL DOMINANT
PMP22	罗-雷二氏遗传性运动失调性起立困难	ROUSSY-LEVY HEREDITARY AREFLEXIC DYSTASIA
MPZ	罗-雷二氏遗传性运动失调性起立困难	ROUSSY-LEVY HEREDITARY AREFLEXIC DYSTASIA
ANK1	球形红细胞增多症	SPHEROCYTOSIS, TYPE 1
COL2A1	脊椎骨骺发育不良	SPONDYLOEPIPHYSEAL DYSPLASIA CONGENITA
COL2A1	脊椎干骺端发育不良	SPONDYLOEPIMETAPHYSEAL DYSPLASIA, STRUDWICK TYPE
COL11A2	斯蒂克勒综合征	STICKLER SYNDROME, TYPE III
FBN1	僵硬性皮肤综合征	STIFF SKIN SYNDROME
GATA6	法洛四联症	TETRALOGY OF FALLOT
TBX1	法洛四联症	TETRALOGY OF FALLOT
MPL	特发性血小板增多症	THROMBOCYTHEMIA 1
DLX3	毛发-齿-骨综合征	TRICHODENTOOSSEOUS SYNDROME
TSC1	结节性硬化症	TUBEROUS SCLEROSIS 1
TREX1	脑白质营养不良	VASCULOPATHY, RETINAL, WITH CEREBRAL LEUKODYSTROPHY
MYLK2	家族性肥厚型心肌病	CARDIOMYOPATHY, FAMILIAL HYPERTROPHIC, 1
CAV3	家族性肥厚型心肌病	CARDIOMYOPATHY, FAMILIAL HYPERTROPHIC, 1
PAX3	瓦登伯革氏症候群	WAARDENBURG SYNDROME, TYPE 1
KRT4	黏膜白色海绵痣	WHITE SPONGE NEVUS 1
MTTP	无β脂蛋白血症	ABETALIPOPROTEINEMIA
TRIP11	软骨发育不全	ACHONDROGENESIS, TYPE IA
KIF7	Acrocallosa综合征	ACROCALLOSAL SYNDROME
SMN1	脊髓性肌萎缩症	SPINAL MUSCULAR ATROPHY, TYPE IV
STAT1	先天性肾上腺皮质增生症	LIPOID CONGENITAL ADRENAL HYPERPLASIA
HSD3B2	氧化还原酶缺乏症	3-@BETA-HYDROXYSTEROID DEHYDROGENASE, TYPE II, DEFICIENCY OF
CYP21A2	先天性肾上腺皮质增生症	ADRENAL HYPERPLASIA, CONGENITAL, DUE TO 21-HYDROXYLASE DEFICIENCY
TP53	遗传性肾上腺皮质癌	ADRENOCORTICAL CARCINOMA, HEREDITARY
PEX13	雷夫叙姆病	PEROXISOME BIOGENESIS DISORDER 2B
FGA	先天性纤维蛋白原缺乏症	AFIBRINOGENEMIA, CONGENITAL
PRRX1	无颌-耳头畸形综合症状	AGNATHIA-OTOCEPHALY COMPLEX
HPS6	Hermansky-Pudlak综合征	HERMANSKY-PUDLAK SYNDROME 1
HPS1	Hermansky-Pudlak综合征	HERMANSKY-PUDLAK SYNDROME 1
COL4A4	ALPORT综合征	ALPORT SYNDROME, AUTOSOMAL RECESSIVE
BEST1	莱伯氏先天性黑矇	LEBER CONGENITAL AMAUROSIS 1
CNGA3	莱伯氏先天性黑矇	LEBER CONGENITAL AMAUROSIS 1
RPE65	莱伯氏先天性黑矇	LEBER CONGENITAL AMAUROSIS 2
CLN3	神经元蜡样质脂褐质沉积症	CEROID LIPOFUSCINOSIS, NEURONAL, 3
CLN6	神经元蜡样质脂褐质沉积症	CEROID LIPOFUSCINOSIS, NEURONAL, 4A, AUTOSOMAL RECESSIVE
TMPRSS6	铁不应性缺铁性贫血	IRON-REFRACTORY IRON DEFICIENCY ANEMIA
ACTA1	胎儿运动机能丧失变型序列	FETAL AKINESIA DEFORMATION SEQUENCE
PRG4	指弯曲关节病髋内翻心包炎综合征	CAMPTODACTYLY-ARTHROPATHY-COXA VARA-PERICARDITIS SYNDROME
EDN3	先天性中枢性低通气综合征	CENTRAL HYPOVENTILATION SYNDROME, CONGENITAL
PHOX2B	先天性中枢性低通气综合征	CENTRAL HYPOVENTILATION SYNDROME, CONGENITAL
TTC8	BARDET-BIEDL综合征	BARDET-BIEDL SYNDROME 1
MKS1	BARDET-BIEDL综合征	BARDET-BIEDL SYNDROME 1
MKKS	BARDET-BIEDL综合征	BARDET-BIEDL SYNDROME 1
CEP290	BARDET-BIEDL综合征	BARDET-BIEDL SYNDROME 1
ARL6	BARDET-BIEDL综合征	BARDET-BIEDL SYNDROME 1
TRIM32	BARDET-BIEDL综合征	BARDET-BIEDL SYNDROME 1
SDCCAG8	BARDET-BIEDL综合征	BARDET-BIEDL SYNDROME 1
TMEM67	BARDET-BIEDL综合征	BARDET-BIEDL SYNDROME 1
CIITA	裸淋巴细胞综合征	BARE LYMPHOCYTE SYNDROME, TYPE II
ABCG8	谷甾醇血症	SITOSTEROLEMIA
BLM	布伦氏综合征	BLOOM SYNDROME
CFTR	支气管扩张	BRONCHIECTASIS WITH OR WITHOUT ELEVATED SWEAT CHLORIDE 1
C20orf54	法-隆病,进行性球麻痹	FAZIO-LONDE DISEASE
C20orf54	Brown-Vialetto-vanLaere综合征	BROWN-VIALETTO-VAN LAERE SYNDROME 1
SLC25A20	转移酶缺乏症	CARNITINE-ACYLCARNITINE TRANSLOCASE DEFICIENCY
AGK	Sengers综合征	SENGERS SYNDROME
PEX6	雷夫叙姆病	PEROXISOME BIOGENESIS DISORDER 1A (ZELLWEGER)
PEX10	雷夫叙姆病	PEROXISOME BIOGENESIS DISORDER 1A (ZELLWEGER)
PEX3	雷夫叙姆病	PEROXISOME BIOGENESIS DISORDER 1A (ZELLWEGER)
PEX19	雷夫叙姆病	PEROXISOME BIOGENESIS DISORDER 1A (ZELLWEGER)
MYO5A	格里塞利综合征	GRISCELLI SYNDROME, TYPE 1
SLC26A3	腹泻	DIARRHEA 1, SECRETORY CHLORIDE, CONGENITAL
CHD7	CHARGE综合征	CHARGE SYNDROME
LBR	积液型异位钙化骨骼发育不良	GREENBERG DYSPLASIA
VPS13B	科恩综合征	COHEN SYNDROME
C2	补体成分缺乏症	COMPLEMENT COMPONENT 2 DEFICIENCY
HSD11B2	表观盐皮质类固醇激素过多综合征	APPARENT MINERALOCORTICOID EXCESS
BRAF	Costello综合征	COSTELLO SYNDROME
CFTR	囊样纤维化	CYSTIC FIBROSIS
SLC3A1	胱氨酸尿症	CYSTINURIA
FASTKD2	线粒体复合物缺乏症	MITOCHONDRIAL COMPLEX IV DEFICIENCY
GLYCTK	D-甘油酸尿	D-GLYCERIC ACIDURIA
KCNQ1	耶韦尔和朗格-尼尔森综合征	JERVELL AND LANGE-NIELSEN SYNDROME 1
DLX5	手裂/足裂畸形	SPLIT-HAND/FOOT MALFORMATION 1 WITH SENSORINEURAL HEARING LOSS, AUTOSOMAL
CSF1R	脑白质病	LEUKOENCEPHALOPATHY, DIFFUSE HEREDITARY, WITH SPHEROIDS
TTC37	毛滴虫肝胆肠综合征	TRICHOHEPATOENTERIC SYNDROME 1
BPGM	转移酶缺乏症	BISPHOSPHOGLYCERATE MUTASE DEFICIENCY
HSPG2	异常分离发育不良	DYSSEGMENTAL DYSPLASIA, SILVERMAN-HANDMAKER TYPE
ORC1	Meier-Gorlin综合征	MEIER-GORLIN SYNDROME 1
EVC2	埃利伟氏综合症	ELLIS-VAN CREVELD SYNDROME
EVC	埃利伟氏综合症	ELLIS-VAN CREVELD SYNDROME
COL7A1	大疱性表皮松解症	EPIDERMOLYSIS BULLOSA DYSTROPHICA, AUTOSOMAL RECESSIVE
COL17A1	大疱性表皮松解症	EPIDERMOLYSIS BULLOSA, JUNCTIONAL, NON-HERLITZ TYPE
LAMA3	大疱性表皮松解症	EPIDERMOLYSIS BULLOSA, JUNCTIONAL, NON-HERLITZ TYPE
PLEC	单纯型大疱性表皮松解症	EPIDERMOLYSIS BULLOSA SIMPLEX WITH MUSCULAR DYSTROPHY
LAMC2	大疱性表皮松解症	EPIDERMOLYSIS BULLOSA, JUNCTIONAL, HERLITZ TYPE
LAMA3	大疱性表皮松解症	EPIDERMOLYSIS BULLOSA, JUNCTIONAL, HERLITZ TYPE
ROGDI	KOHLSCHUTTER-TONZ综合征	KOHLSCHUTTER-TONZ SYNDROME
TWIST2	颞颥萎缩斑颏条状凹陷综合征	FOCAL FACIAL DERMAL DYSPLASIA 3, SETLEIS TYPE
FANCL	范可尼贫血	FANCONI ANEMIA, COMPLEMENTATION GROUP A
FANCG	范可尼贫血	FANCONI ANEMIA, COMPLEMENTATION GROUP A
FANCD2	范可尼贫血	FANCONI ANEMIA, COMPLEMENTATION GROUP A
FANCC	范可尼贫血	FANCONI ANEMIA, COMPLEMENTATION GROUP A
FANCB	范可尼贫血	FANCONI ANEMIA, COMPLEMENTATION GROUP A
FANCF	范可尼贫血	FANCONI ANEMIA, COMPLEMENTATION GROUP A
FANCI	范可尼贫血	FANCONI ANEMIA, COMPLEMENTATION GROUP A
FANCE	范可尼贫血	FANCONI ANEMIA, COMPLEMENTATION GROUP A
RAD51C	范可尼贫血	FANCONI ANEMIA, COMPLEMENTATION GROUP A
FANCM	范可尼贫血	FANCONI ANEMIA, COMPLEMENTATION GROUP A
COL11A1	短肢骨骼发育不全	FIBROCHONDROGENESIS 1
PLA2G5	家族性良性斑纹状视网膜	FLECK RETINA, FAMILIAL BENIGN
KHK	果糖尿症	FRUCTOSURIA, ESSENTIAL
TBXAS1	骨发育不良	GHOSAL HEMATODIAPHYSEAL DYSPLASIA
HADH	3羟酰-CoA脱氢酶缺乏	3-@HYDROXYACYL-CoA DEHYDROGENASE DEFICIENCY
C7orf10	戊二酸尿症	GLUTARIC ACIDURIA III
G6PC	糖原贮积症	GLYCOGEN STORAGE DISEASE Ia
HSD17B4	Perrault综合征	PERRAULT SYNDROME 1
GJA1	Hallermann-Streiff综合征	HALLERMANN-STREIFF SYNDROME
PANK2	大脑铁沉积性神经退行性变	NEURODEGENERATION WITH BRAIN IRON ACCUMULATION 1
SP110	伴免疫缺陷的肝静脉闭塞性疾病	HEPATIC VENOOCCLUSIVE DISEASE WITH IMMUNODEFICIENCY
HK1	溶血性贫血	HEMOLYTIC ANEMIA, NONSPHEROCYTIC, DUE TO HEXOKINASE DEFICIENCY
ZEB2	Mowat-Wilson综合征	MOWAT-WILSON SYNDROME
MTRR	高胱氨酸尿症	HOMOCYSTINURIA-MEGALOBLASTIC ANEMIA, cblE COMPLEMENTATION TYPE
PSMB8	自发性炎症,脂肪代谢障碍和皮肤病综合征	AUTOINFLAMMATION, LIPODYSTROPHY, AND DERMATOSIS SYNDROME
SLCO1B3	家族性高胆红素血症	HYPERBILIRUBINEMIA, ROTOR TYPE
SLCO1B1	家族性高胆红素血症	HYPERBILIRUBINEMIA, ROTOR TYPE
LHCGR	间质细胞发育不良I型(男性假两性畸形)	LEYDIG CELL HYPOPLASIA, TYPE I
AASS	高赖氨酸血症	HYPERLYSINEMIA, TYPE I
SOST	全身性骨皮质增厚	HYPEROSTOSIS CORTICALIS GENERALISATA
PIGV	高磷酸酯酶伴精神发育迟滞综合征	HYPERPHOSPHATASIA WITH MENTAL RETARDATION SYNDROME 1
ALDH4A1	血脯氨酸过多症	HYPERPROLINEMIA, TYPE II
DCAF17	性腺功能减退,脱发,糖尿病综合征	WOODHOUSE-SAKATI SYNDROME
ALOX12B	鱼鳞病	ICHTHYOSIS, CONGENITAL, AUTOSOMAL RECESSIVE 2
ACTB	BARAITSER-WINTER综合征	BARAITSER-WINTER SYNDROME 1
DNAI1	原发性纤毛运动障碍	CILIARY DYSKINESIA, PRIMARY, 1
CEBPE	特异性颗粒缺陷	SPECIFIC GRANULE DEFICIENCY
CHST3	多个关节脱位,身材矮小,颅面异形和先天性心脏缺陷	MULTIPLE JOINT DISLOCATIONS, SHORT STATURE, CRANIOFACIAL DYSMORPHISM,
B3GAT3	多个关节脱位,身材矮小,颅面异形和先天性心脏缺陷	MULTIPLE JOINT DISLOCATIONS, SHORT STATURE, CRANIOFACIAL DYSMORPHISM,
LAMA3	喉-甲-皮肤综合征	LARYNGOONYCHOCUTANEOUS SYNDROME
HMGCL	裂解酶缺乏症	3-@HYDROXY-3-METHYLGLUTARYL-CoA LYASE DEFICIENCY
PRPH2	黄色斑点状眼底	STARGARDT DISEASE 1
FREM1	曼尼托巴省Oculotrichoanal综合症	MANITOBA OCULOTRICHOANAL SYNDROME
BCKDHA	枫糖尿症	MAPLE SYRUP URINE DISEASE
SPG21	遗传性痉挛性截瘫	MAST SYNDROME
MKS1	Meckel综合征	MECKEL SYNDROME, TYPE 1
SH3PXD2B	Frank-TerHaar综合征	FRANK-TER HAAR SYNDROME
PRSS12	智力低下	MENTAL RETARDATION, AUTOSOMAL RECESSIVE 1
SHOX	肢中部型侏儒	LANGER MESOMELIC DYSPLASIA
RMRP	软骨-毛发发育不全	CARTILAGE-HAIR HYPOPLASIA
RMRP	干骺端发育不良无少毛症	METAPHYSEAL DYSPLASIA WITHOUT HYPOTRICHOSIS
RBBP8	JAWAD综合征	JAWAD SYNDROME
MRE11A	NIJMEGEN断裂综合征	NIJMEGEN BREAKAGE SYNDROME
CANT1	软骨发育不全	DESBUQUOIS DYSPLASIA 1
LTBP2	小球形晶状棒	MICROSPHEROPHAKIA AND/OR MEGALOCORNEA, WITH ECTOPIA LENTIS AND WITH
NDUFAF2	线粒体复合物I缺乏症	MITOCHONDRIAL COMPLEX I DEFICIENCY
NDUFV2	线粒体复合物I缺乏症	MITOCHONDRIAL COMPLEX I DEFICIENCY
NDUFS1	线粒体复合物I缺乏症	MITOCHONDRIAL COMPLEX I DEFICIENCY
NDUFS4	线粒体复合物I缺乏症	MITOCHONDRIAL COMPLEX I DEFICIENCY
FOXRED1	线粒体复合物I缺乏症	MITOCHONDRIAL COMPLEX I DEFICIENCY
NDUFV1	线粒体复合物I缺乏症	MITOCHONDRIAL COMPLEX I DEFICIENCY
NDUFS2	线粒体复合物I缺乏症	MITOCHONDRIAL COMPLEX I DEFICIENCY
NDUFS6	线粒体复合物I缺乏症	MITOCHONDRIAL COMPLEX I DEFICIENCY
AMACR	线粒体复合物I缺乏症	MITOCHONDRIAL COMPLEX I DEFICIENCY
C20orf7	线粒体复合物I缺乏症	MITOCHONDRIAL COMPLEX I DEFICIENCY
NDUFAF3	线粒体复合物I缺乏症	MITOCHONDRIAL COMPLEX I DEFICIENCY
NDUFAF4	线粒体复合物I缺乏症	MITOCHONDRIAL COMPLEX I DEFICIENCY
NDUFA1	线粒体复合物I缺乏症	MITOCHONDRIAL COMPLEX I DEFICIENCY
NDUFA11	线粒体复合物I缺乏症	MITOCHONDRIAL COMPLEX I DEFICIENCY
NUBPL	线粒体复合物I缺乏症	MITOCHONDRIAL COMPLEX I DEFICIENCY
AIFM1	线粒体复合物I缺乏症	MITOCHONDRIAL COMPLEX I DEFICIENCY
NDUFS3	线粒体复合物I缺乏症	MITOCHONDRIAL COMPLEX I DEFICIENCY
SDHA	线粒体复合物缺乏症	MITOCHONDRIAL COMPLEX II DEFICIENCY
GNPTAB	粘脂贮积病	MUCOLIPIDOSIS II ALPHA/BETA
GNPTG	粘脂贮积病	MUCOLIPIDOSIS III GAMMA
FKTN	肌营养不良-抗肌萎缩相关糖蛋白病	MUSCULAR DYSTROPHY-DYSTROGLYCANOPATHY (CONGENITAL WITH BRAIN AND EYE
COL6A1	先天性肌营养不良	ULLRICH CONGENITAL MUSCULAR DYSTROPHY
DOK7	肢带型肌无力	MYASTHENIA, LIMB-GIRDLE, FAMILIAL
AGRN	肢带型肌无力	MYASTHENIA, LIMB-GIRDLE, FAMILIAL
PRKAR1A	心脏粘液瘤	MYXOMA, INTRACARDIAC
SCO2	Leigh综合征	LEIGH SYNDROME
TACO1	Leigh综合征	LEIGH SYNDROME
COX15	Leigh综合征	LEIGH SYNDROME
NEB	线状体肌病	NEMALINE MYOPATHY 2
PPT1	神经元蜡样质脂褐质沉积症	CEROID LIPOFUSCINOSIS, NEURONAL, 1
MASP1	3MC综合征	3MC SYNDROME 1
SAG	先天性夜盲症	OGUCHI DISEASE 1
TCTN3	口面指综合征	OROFACIODIGITAL SYNDROME IV
UMPS	乳清酸尿症	OROTIC ACIDURIA
LEPRE1	成骨不全症	OSTEOGENESIS IMPERFECTA, TYPE III
MMP2	Torg-Winchester综合征	MULTICENTRIC OSTEOLYSIS, NODULOSIS, AND ARTHROPATHY
ATP6V1B1	骨硬化病	OSTEOPETROSIS, AUTOSOMAL RECESSIVE 3
SBDS	Shwachman-Diamond综合征	SHWACHMAN-DIAMOND SYNDROME
TP53	脉络丛乳头状瘤	PAPILLOMA OF CHOROID PLEXUS
AIMP1	脑白质营养不良伴髓鞘发育不良	LEUKODYSTROPHY, HYPOMYELINATING, 3
AMHR2	持久苗勒管综合征	PERSISTENT MULLERIAN DUCT SYNDROME, TYPES I AND II
INSR	松果体增生,胰岛素抗性糖尿病和体细胞异常	PINEAL HYPERPLASIA, INSULIN-RESISTANT DIABETES MELLITUS, AND SOMATIC
ABCA1	斯科格综合征	SCOTT SYNDROME
RIPK4	腘翼状胬肉综合征	POPLITEAL PTERYGIUM SYNDROME, LETHAL TYPE
DHODH	面骨发育不全综合征	POSTAXIAL ACROFACIAL DYSOSTOSIS
SCNN1A	假性醛固酮过少症	PSEUDOHYPOALDOSTERONISM, TYPE I, AUTOSOMAL RECESSIVE
SCNN1G	假性醛固酮过少症	PSEUDOHYPOALDOSTERONISM, TYPE I, AUTOSOMAL RECESSIVE
SCNN1B	假性醛固酮过少症	PSEUDOHYPOALDOSTERONISM, TYPE I, AUTOSOMAL RECESSIVE
COLEC11	3MC综合征	3MC SYNDROME 2
SLC34A2	肺泡微结石症	PULMONARY ALVEOLAR MICROLITHIASIS
IFT140	窒息性胸廓发育不良	SHORT-RIB THORACIC DYSPLASIA 9 WITH OR WITHOUT POLYDACTYLY
DIS3L2	Perlman综合征	PERLMAN SYNDROME
NPHP3	Meckel综合征	MECKEL SYNDROME, TYPE 7
AK2	网状细胞发育不全	RETICULAR DYSGENESIS
SETBP1	Schinzel-Giedion面中部回缩综合征	SCHINZEL-GIEDION MIDFACE RETRACTION SYNDROME
EMX2	脑裂畸形	SCHIZENCEPHALY
BSCL2	先天性全身性脂肪营养不良	LIPODYSTROPHY, CONGENITAL GENERALIZED, TYPE 2
COL2A1	脊椎骨骺发育不良	SPONDYLOPERIPHERAL DYSPLASIA
TSHB	甲状腺功能减退症	HYPOTHYROIDISM, CONGENITAL, NONGOITROUS, 1
ZMPSTE24	致死性限制性真皮病	RESTRICTIVE DERMOPATHY, LETHAL
TCN2	钴胺传递蛋白II缺乏症	TRANSCOBALAMIN II DEFICIENCY
MSH6	错配修复癌综合征	MISMATCH REPAIR CANCER SYNDROME
FAH	水解酶缺乏症	TYROSINEMIA, TYPE I
UROC1	水解酶缺乏症	UROCANASE DEFICIENCY
CLRN1	尤塞氏综合症	USHER SYNDROME, TYPE I
PDZD7	尤塞氏综合症	USHER SYNDROME, TYPE IIA
TTPA	Friedreich共济失调	VITAMIN E, FAMILIAL ISOLATED DEFICIENCY OF
COL11A2	Weissenbacher-Zweymuller综合征	WEISSENBACHER-ZWEYMULLER SYNDROME
ATP6V0A2	皱皮综合征	WRINKLY SKIN SYNDROME
ERCC2	着色性干皮病	XERODERMA PIGMENTOSUM, COMPLEMENTATION GROUP D
ERCC4	着色性干皮病	XERODERMA PIGMENTOSUM, COMPLEMENTATION GROUP G
PIGL	CHIME综合征	COLOBOMA, CONGENITAL HEART DISEASE, ICHTHYOSIFORM DERMATOSIS, MENTAL
CLCN5	Dent病	DENT DISEASE 1
FLNA	慢性假性肠梗阻	INTESTINAL PSEUDOOBSTRUCTION, NEURONAL, CHRONIC IDIOPATHIC, X-LINKED
SMPX	先天性耳聋	DEAFNESS, X-LINKED 4
XIST	X染色体失活	X INACTIVATION, FAMILIAL SKEWED, 1
ABCD1	肾上腺脑白质营养不良	ADRENOLEUKODYSTROPHY
MAMLD1	肌管性肌病	MYOTUBULAR MYOPATHY WITH ABNORMAL GENITAL DEVELOPMENT
IKBKG	无汗的外胚层发育不良伴免疫缺陷,骨硬化症与淋巴水肿	ECTODERMAL DYSPLASIA, ANHIDROTIC, WITH IMMUNODEFICIENCY, OSTEOPETROSIS,
SLC6A8	X-连锁肌酸缺乏综合征	CEREBRAL CREATINE DEFICIENCY SYNDROME 1
FAM123B	纹状骨瘤伴颅硬化症	OSTEOPATHIA STRIATA WITH CRANIAL SCLEROSIS
CACNA1F	锥杆营养不良	CONE-ROD DYSTROPHY, X-LINKED, 3
RAB40AL	X连锁智力低下	MENTAL RETARDATION, X-LINKED, SYNDROMIC, MARTIN-PROBST TYPE
OCRL	Dent病	DENT DISEASE 2
PHKA1	糖原贮积症	GLYCOGEN STORAGE DISEASE, TYPE IXd
CACNA1F	奥兰岛眼病	ALAND ISLAND EYE DISEASE
CYBB	免疫缺陷	IMMUNODEFICIENCY 34
PRPS1	磷酸核糖焦磷酸合成酶超活性	PHOSPHORIBOSYLPYROPHOSPHATE SYNTHETASE SUPERACTIVITY
HSD17B10	Xp11.22微重复综合征	CHROMOSOME Xp11.22 DUPLICATION SYNDROME
F9	血栓	THROMBOPHILIA, X-LINKED, DUE TO FACTOR IX DEFECT
AIFM1	组合型氧化磷酸化缺陷症	COMBINED OXIDATIVE PHOSPHORYLATION DEFICIENCY 6
PTCHD1	自闭症	AUTISM, SUSCEPTIBILITY TO, X-LINKED 4
NSDHL	CK综合征	CK SYNDROME
GATA1	无血小板减少症贫血	ANEMIA, X-LINKED, WITH OR WITHOUT NEUTROPENIA AND/OR PLATELET ABNORMALITIES
MAGT1	免疫缺陷	IMMUNODEFICIENCY, X-LINKED, WITH MAGNESIUM DEFECT, EPSTEIN-BARR VIRUS
NAA10	转移酶缺乏症	OGDEN SYNDROME
UBQLN2	肌萎缩侧索硬化	AMYOTROPHIC LATERAL SCLEROSIS 15 WITH OR WITHOUT FRONTOTEMPORAL DEMENTIA
UBE2A	X连锁智力低下	MENTAL RETARDATION, X-LINKED, SYNDROMIC, NASCIMENTO TYPE
PIGA	多发性先天异常-肌张力低下-癫痫综合征	MULTIPLE CONGENITAL ANOMALIES-HYPOTONIA-SEIZURES SYNDROME 2
OPN1LW	部分色盲	COLORBLINDNESS, PARTIAL, PROTAN SERIES
GK	高甘油血症	GLYCEROL KINASE DEFICIENCY
BTK	单一性生长素缺乏症	ISOLATED GROWTH HORMONE DEFICIENCY, TYPE III
IKBKG	色素失调症	INCONTINENTIA PIGMENTI
KAL1	性腺机能减退1型伴或不伴嗅觉丧失	HYPOGONADOTROPIC HYPOGONADISM 1 WITH OR WITHOUT ANOSMIA
CHRDL1	巨角膜	MEGALOCORNEA
HDAC8	X连锁智力低下	WILSON-TURNER X-LINKED MENTAL RETARDATION SYNDROME
CLCN5	肾结石	NEPHROLITHIASIS, X-LINKED RECESSIVE, WITH RENAL FAILURE
OFD1	口面指综合征	OROFACIODIGITAL SYNDROME I
OTC	转移酶缺乏症	ORNITHINE TRANSCARBAMYLASE DEFICIENCY, HYPERAMMONEMIA DUE TO
FLNA	耳腭指综合征	OTOPALATODIGITAL SYNDROME, TYPE I
PDHA1	氧化还原酶缺乏症	PYRUVATE DEHYDROGENASE E1-ALPHA DEFICIENCY
GPC3	过度生长综合征	SIMPSON-GOLABI-BEHMEL SYNDROME, TYPE 1
PLP1	遗传性痉挛性截瘫	SPASTIC PARAPLEGIA 2, X-LINKED
TRAPPC2	脊椎骨骺发育不良	SPONDYLOEPIPHYSEAL DYSPLASIA TARDA, X-LINKED
WAS	血小板减少症	THROMBOCYTOPENIA 1
ZIC3	VACTERL综合征	VACTERL ASSOCIATION, X-LINKED, WITH OR WITHOUT HYDROCEPHALUS
FLNA	心脏瓣膜发育不良	CARDIAC VALVULAR DYSPLASIA, X-LINKED
SRY	46,性反转	46,XY SEX REVERSAL 1
GATA6	胰腺发育不全及先天性心脏缺陷	HEART DEFECTS, CONGENITAL, AND OTHER CONGENITAL ANOMALIES
CYP2R1	维生素D缺乏性佝偻病	VITAMIN D HYDROXYLATION-DEFICIENT RICKETS, TYPE 1B
KCNQ4	先天性耳聋	DEAFNESS, AUTOSOMAL DOMINANT 2A
COL9A2	多发性骨骺发育不良	EPIPHYSEAL DYSPLASIA, MULTIPLE, 2
SPECC1L	面斜裂	FACIAL CLEFTING, OBLIQUE, 1
TSC2	多囊肾病	POLYCYSTIC KIDNEY DISEASE, INFANTILE SEVERE, WITH TUBEROUS SCLEROSIS
MAPT	额颞痴呆	FRONTOTEMPORAL DEMENTIA
HDAC4	短指(趾)-智力低下综合征	BRACHYDACTYLY-MENTAL RETARDATION SYNDROME
ERCC6	紫外线敏感综合征	UV-SENSITIVE SYNDROME 1
GARS	远端遗传性运动神经元病	NEURONOPATHY, DISTAL HEREDITARY MOTOR, TYPE VA
BSCL2	远端遗传性运动神经元病	NEURONOPATHY, DISTAL HEREDITARY MOTOR, TYPE VA
JAK3	复合型免疫缺陷	SEVERE COMBINED IMMUNODEFICIENCY, AUTOSOMAL RECESSIVE, T CELL-NEGATIVE,
CRYBA1	白内障	CATARACT 10, MULTIPLE TYPES
FTL	高铁蛋白血症白内障综合征	HYPERFERRITINEMIA WITH OR WITHOUT CATARACT
SCARF2	VanDenEnde-Gupta综合征	VAN DEN ENDE-GUPTA SYNDROME
PCSK1	前蛋白转化1/3缺乏症	PROPROTEIN CONVERTASE 1/3 DEFICIENCY
SLC2A1	肌张力障碍	DYSTONIA 9
MAPT	进行性核上性麻痹	SUPRANUCLEAR PALSY, PROGRESSIVE, 1
JUP	Naxos病	NAXOS DISEASE
ATCAY	小脑性共济失调	CEREBELLAR ATAXIA, CAYMAN TYPE
NF1	神经纤维瘤病	NEUROFIBROMATOSIS-NOONAN SYNDROME
SMARCA2	NICOLAIDES-BARAITSER综合征	NICOLAIDES-BARAITSER SYNDROME
ATP2B2	先天性耳聋	DEAFNESS, AUTOSOMAL RECESSIVE 12
CHRNA1	肌无力综合征	MYASTHENIC SYNDROME, CONGENITAL, SLOW-CHANNEL
GARS	腓骨肌萎缩症	CHARCOT-MARIE-TOOTH DISEASE, AXONAL, TYPE 2D
GJB2	先天性耳聋	DEAFNESS, AUTOSOMAL DOMINANT 3A
LIFR	Stuve-Wiedemann综合征	STUVE-WIEDEMANN SYNDROME
ERCC2	毛发硫营养不良	TRICHOTHIODYSTROPHY, PHOTOSENSITIVE
SLC12A1	Bartter综合征	BARTTER SYNDROME, ANTENATAL, TYPE 1
CLCNKB	Bartter综合征	BARTTER SYNDROME, ANTENATAL, TYPE 1
MYH3	远端关节弯曲	ARTHROGRYPOSIS, DISTAL, TYPE 2B
FAS	自身免疫性淋巴细胞增生综合征	AUTOIMMUNE LYMPHOPROLIFERATIVE SYNDROME
FASLG	自身免疫性淋巴细胞增生综合征	AUTOIMMUNE LYMPHOPROLIFERATIVE SYNDROME
GIPC3	先天性耳聋	DEAFNESS, AUTOSOMAL RECESSIVE 15
GJA3	白内障	CATARACT 14, MULTIPLE TYPES
FN1	纤维连接蛋白沉积肾小球病	GLOMERULOPATHY WITH FIBRONECTIN DEPOSITS 2
PRRT2	家族性婴儿抽搐伴阵发性舞蹈手足徐动	CONVULSIONS, FAMILIAL INFANTILE, WITH PAROXYSMAL CHOREOATHETOSIS
PCDH15	尤塞氏综合症	USHER SYNDROME, TYPE IF
USH1C	先天性耳聋	DEAFNESS, AUTOSOMAL RECESSIVE 18A
LIG4	复合型免疫缺陷	SEVERE COMBINED IMMUNODEFICIENCY WITH SENSITIVITY TO IONIZING RADIATION
NFIX	Marshall-Smith综合征	MARSHALL-SMITH SYNDROME
CHKB	先天性肌营养不良	MUSCULAR DYSTROPHY, CONGENITAL, MEGACONIAL TYPE
SEPN1	强直性脊柱肌营养不良	RIGID SPINE MUSCULAR DYSTROPHY 1
SLC29A3	组织细胞增生症淋巴结病叠加综合征	HISTIOCYTOSIS-LYMPHADENOPATHY PLUS SYNDROME
NPR2	肢端肢中发育不全	ACROMESOMELIC DYSPLASIA, MAROTEAUX TYPE
COLQ	水解酶缺乏症	ENDPLATE ACETYLCHOLINESTERASE DEFICIENCY
CCM2	脑海绵状血管畸形	CEREBRAL CAVERNOUS MALFORMATIONS 2
PDCD10	脑海绵状血管畸形	CEREBRAL CAVERNOUS MALFORMATIONS 3
DNAJB6	肌营养不良	MUSCULAR DYSTROPHY, LIMB-GIRDLE, TYPE 1E
KIF22	脊椎干骺端发育不良	SPONDYLOEPIMETAPHYSEAL DYSPLASIA WITH JOINT LAXITY TYPE 2
SLC35A1	先天性糖基化障碍	CONGENITAL DISORDER OF GLYCOSYLATION, TYPE IIf
KAT6B	OHDO综合征	OHDO SYNDROME, SBBYS VARIANT
APOA1	原发性高脂血症	HYPOALPHALIPOPROTEINEMIA, PRIMARY
ABCA1	原发性高脂血症	HYPOALPHALIPOPROTEINEMIA, PRIMARY
ABCA4	锥杆营养不良	CONE-ROD DYSTROPHY 3
LOR	Vohwinkel综合征伴鱼鳞病	VOHWINKEL SYNDROME, VARIANT FORM
COL7A1	大疱性表皮松解症	EPIDERMOLYSIS BULLOSA PRURIGINOSA
TTN	扩张型心肌病	CARDIOMYOPATHY, DILATED, 1G
C16orf57	中性粒细胞减少伴皮肤异色症	POIKILODERMA WITH NEUTROPENIA
GPSM2	CHUDLEY-MCCULLOUGH综合征	CHUDLEY-MCCULLOUGH SYNDROME
PAX2	Peters异常	PETERS ANOMALY
SCN1B	全身性癫痫伴热性惊厥附加症	GENERALIZED EPILEPSY WITH FEBRILE SEIZURES PLUS, TYPE 1
GHR	特发性身材矮小	GROWTH HORMONE INSENSITIVITY, PARTIAL
WDR62	常染色体隐性遗传原发性小头畸形	MICROCEPHALY 2, PRIMARY, AUTOSOMAL RECESSIVE, WITH OR WITHOUT CORTICAL
CEP152	常染色体隐性遗传原发性小头畸形	MICROCEPHALY 4, PRIMARY, AUTOSOMAL RECESSIVE
CHN1	眼球后退综合征	DUANE RETRACTION SYNDROME 2
SPG11	遗传性痉挛性截瘫	SPASTIC PARAPLEGIA 11, AUTOSOMAL RECESSIVE
MRE11A	共济失调性毛细血管扩张症	ATAXIA-TELANGIECTASIA-LIKE DISORDER 1
AIPL1	莱伯氏先天性黑矇	LEBER CONGENITAL AMAUROSIS 4
SCN1A	全身性癫痫伴热性惊厥附加症	GENERALIZED EPILEPSY WITH FEBRILE SEIZURES PLUS, TYPE 2
TFG	神经病变	NEUROPATHY, HEREDITARY MOTOR AND SENSORY, OKINAWA TYPE
MPL	血小板减少症	AMEGAKARYOCYTIC THROMBOCYTOPENIA, CONGENITAL
TRPM4	进行性家族性心脏传导阻滞	PROGRESSIVE FAMILIAL HEART BLOCK, TYPE IB
TAP1	裸淋巴细胞综合征	BARE LYMPHOCYTE SYNDROME, TYPE I
TAP2	裸淋巴细胞综合征	BARE LYMPHOCYTE SYNDROME, TYPE I
CDK5RAP2	常染色体隐性遗传原发性小头畸形	MICROCEPHALY 3, PRIMARY, AUTOSOMAL RECESSIVE
RTN2	遗传性痉挛性截瘫	SPASTIC PARAPLEGIA 12, AUTOSOMAL DOMINANT
H6PD	氧化还原酶缺乏症	CORTISONE REDUCTASE DEFICIENCY 1
HSD11B1	氧化还原酶缺乏症	CORTISONE REDUCTASE DEFICIENCY 1
ANGPTL3	家族性低β脂蛋白血症	HYPOBETALIPOPROTEINEMIA, FAMILIAL, 2
MET	肾细胞癌	RENAL CELL CARCINOMA, PAPILLARY, 1
MLL	多毛肘,身材矮小,面部异形和发育迟缓	HAIRY ELBOWS, SHORT STATURE, FACIAL DYSMORPHISM, AND DEVELOPMENTAL
SIX1	先天性耳聋	DEAFNESS, AUTOSOMAL DOMINANT 23
CHSY1	短指综合征	TEMTAMY PREAXIAL BRACHYDACTYLY SYNDROME
SDHC	副神经节瘤	PARAGANGLIOMAS 3
APCDD1	少毛症	HYPOTRICHOSIS 1
HOXA11	伴巨核细胞血小板减少的桡尺骨融合症	RADIOULNAR SYNOSTOSIS WITH AMEGAKARYOCYTIC THROMBOCYTOPENIA
NFU1	多线粒体功能障碍综合征	MULTIPLE MITOCHONDRIAL DYSFUNCTIONS SYNDROME 1
PRRT2	癫痫	SEIZURES, BENIGN FAMILIAL INFANTILE, 2
GCSH	甘氨酸脑病	GLYCINE ENCEPHALOPATHY
TALDO1	转移酶缺乏症	TRANSALDOLASE DEFICIENCY
KAT6B	生殖器-髌骨综合征	GENITOPATELLAR SYNDROME
SHANK3	phelan-mcdermid综合征	PHELAN-MCDERMID SYNDROME
ALS2	青少年原发性侧索硬化症	PRIMARY LATERAL SCLEROSIS, JUVENILE
IL2RA	白细胞介素2受体α链缺陷	INTERLEUKIN 2 RECEPTOR, ALPHA, DEFICIENCY OF
PDX1	青年发病的成年型糖尿病	MATURITY-ONSET DIABETES OF THE YOUNG, TYPE 4
NEUROD1	青年发病的成年型糖尿病	MATURITY-ONSET DIABETES OF THE YOUNG, TYPE 6
TNXB	Ehlers-Danlos综合征	EHLERS-DANLOS SYNDROME DUE TO TENASCIN-X DEFICIENCY
SLC45A2	白化病	ALBINISM, OCULOCUTANEOUS, TYPE IV
ADCY5	家族性运动障碍伴面部肌肉颤搐	DYSKINESIA, FAMILIAL, WITH FACIAL MYOKYMIA
RBBP8	Seckel综合征	SECKEL SYNDROME 2
DYSF	远端肌病	MYOPATHY, DISTAL, WITH ANTERIOR TIBIAL ONSET
TRPV4	家族性骨关节病-指过短	DIGITAL ARTHROPATHY-BRACHYDACTYLY, FAMILIAL
B4GALT1	先天性糖基化障碍	CONGENITAL DISORDER OF GLYCOSYLATION, TYPE IId
FKTN	肌营养不良-抗肌萎缩相关糖蛋白病	MUSCULAR DYSTROPHY-DYSTROGLYCANOPATHY (LIMB-GIRDLE), TYPE C, 5
SMARCB1	脑膜瘤	MENINGIOMA, FAMILIAL, SUSCEPTIBILITY TO
TMEM67	Meckel综合征	MECKEL SYNDROME, TYPE 3
CCDC50	先天性耳聋	DEAFNESS, AUTOSOMAL DOMINANT 44
ICOS	常见变异型免疫缺陷病	IMMUNODEFICIENCY, COMMON VARIABLE, 1
CLDN1	鱼鳞病	ICHTHYOSIS, LEUKOCYTE VACUOLES, ALOPECIA, AND SCLEROSING CHOLANGITIS
POLR3A	脑白质营养不良伴髓鞘发育不良	LEUKODYSTROPHY, HYPOMYELINATING, 7, WITH OR WITHOUT OLIGODONTIA AND/OR
CAV3	肌营养不良	MUSCULAR DYSTROPHY, LIMB-GIRDLE, TYPE 1C
TSHZ1	先天性外耳道闭锁	AURAL ATRESIA, CONGENITAL
LAMA2	先天性肌营养不良	MUSCULAR DYSTROPHY, CONGENITAL MEROSIN-DEFICIENT, 1A
FSCN2	视网膜色素变性	RETINITIS PIGMENTOSA 30
CSTA	鱼鳞病	EXFOLIATIVE ICHTHYOSIS, AUTOSOMAL RECESSIVE, ICHTHYOSIS BULLOSA OF
ACP5	Spondyloenchondrodysplasia	SPONDYLOENCHONDRODYSPLASIA WITH IMMUNE DYSREGULATION
BMPER	透明脊柱发育不全	DIAPHANOSPONDYLODYSOSTOSIS
TMEM216	朱伯特综合征	JOUBERT SYNDROME 2
ALG8	先天性糖基化障碍	CONGENITAL DISORDER OF GLYCOSYLATION, TYPE Ih
BEST1	黄斑营养不良	MACULAR DYSTROPHY, VITELLIFORM, 3
FBN1	Weill-Marchesani综合征	WEILL-MARCHESANI SYNDROME 2
RASA1	Parkes-Weber综合征	PARKES WEBER SYNDROME
ACAN	脊椎骨骺发育不良	SPONDYLOEPIPHYSEAL DYSPLASIA, KIMBERLEY TYPE
RGS9BP	长时间的视网膜电反应抑制	PROLONGED ELECTRORETINAL RESPONSE SUPPRESSION
ADAMTS18	Knobloch综合征	KNOBLOCH SYNDROME 2
GRHL2	先天性耳聋	DEAFNESS, AUTOSOMAL DOMINANT 28
NTRK1	感觉自主神经病	NEUROPATHY, HEREDITARY SENSORY AND AUTONOMIC, TYPE V
ASPM	常染色体隐性遗传原发性小头畸形	MICROCEPHALY 5, PRIMARY, AUTOSOMAL RECESSIVE
IGF1	胰岛素样生长因子I缺乏症	INSULIN-LIKE GROWTH FACTOR I DEFICIENCY
TSPYL1	睾丸发育不良伴婴儿猝死综合征	SUDDEN INFANT DEATH WITH DYSGENESIS OF THE TESTES SYNDROME
CHRNE	肌无力综合征	MYASTHENIC SYNDROME, CONGENITAL, 4C, ASSOCIATED WITH ACETYLCHOLINE
RAPSN	肌无力综合征	MYASTHENIC SYNDROME, CONGENITAL, 4C, ASSOCIATED WITH ACETYLCHOLINE
CHRNB1	肌无力综合征	MYASTHENIC SYNDROME, CONGENITAL, 4C, ASSOCIATED WITH ACETYLCHOLINE
MUSK	肌无力综合征	MYASTHENIC SYNDROME, CONGENITAL, 4C, ASSOCIATED WITH ACETYLCHOLINE
CD8A	家族性CD8缺乏症	CD8 DEFICIENCY, FAMILIAL
PTPRC	复合型免疫缺陷	SEVERE COMBINED IMMUNODEFICIENCY, AUTOSOMAL RECESSIVE, T CELL-NEGATIVE,
CD3E	复合型免疫缺陷	SEVERE COMBINED IMMUNODEFICIENCY, AUTOSOMAL RECESSIVE, T CELL-NEGATIVE,
IL7R	复合型免疫缺陷	SEVERE COMBINED IMMUNODEFICIENCY, AUTOSOMAL RECESSIVE, T CELL-NEGATIVE,
CD3D	复合型免疫缺陷	SEVERE COMBINED IMMUNODEFICIENCY, AUTOSOMAL RECESSIVE, T CELL-NEGATIVE,
RNF170	感觉性共济失调	ATAXIA, SENSORY, 1, AUTOSOMAL DOMINANT
ESPN	先天性耳聋	DEAFNESS, AUTOSOMAL RECESSIVE 36, WITH OR WITHOUT VESTIBULAR INVOLVEMENT
DIAPH3	听神经病	AUDITORY NEUROPATHY, AUTOSOMAL DOMINANT, 1
PDE8B	纹状体退化	STRIATAL DEGENERATION, AUTOSOMAL DOMINANT
TGFBR1	Loeys-Dietz综合征	LOEYS-DIETZ SYNDROME 1
STOX1	先兆子痫/子痫惊厥	PREECLAMPSIA/ECLAMPSIA 4
BMPR1B	中胚端软骨发育不全伴生殖器畸形	CHONDRODYSPLASIA, ACROMESOMELIC, WITH GENITAL ANOMALIES
FLNC	肌纤维肌病	MYOPATHY, MYOFIBRILLAR, 5
TK2	线粒体DNA缺失综合征	MITOCHONDRIAL DNA DEPLETION SYNDROME 2 (MYOPATHIC TYPE)
KCNJ2	短QT综合征	SHORT QT SYNDROME 3
LPIN2	Majeed综合症	MAJEED SYNDROME
ZIC2	前脑无裂畸形	HOLOPROSENCEPHALY 5
ILDR1	先天性耳聋	DEAFNESS, AUTOSOMAL RECESSIVE 42
ACY1	水解酶缺乏症	AMINOACYLASE 1 DEFICIENCY
MCM4	自然杀伤细胞及糖皮质激素的缺乏伴DNA修复缺陷	NATURAL KILLER CELL AND GLUCOCORTICOID DEFICIENCY WITH DNA REPAIR
FYCO1	白内障	CATARACT 18
SLC16A1	高胰岛素低血糖症	HYPERINSULINEMIC HYPOGLYCEMIA, FAMILIAL, 7
CEP290	senior-loken综合征	SENIOR-LOKEN SYNDROME 6
GLIS3	甲状腺功能减退症	DIABETES MELLITUS, NEONATAL, WITH CONGENITAL HYPOTHYROIDISM
ZNF750	类脂溢性皮炎伴牛皮鲜	SEBORRHEA-LIKE DERMATITIS WITH PSORIASIFORM ELEMENTS
REEP1	遗传性痉挛性截瘫	SPASTIC PARAPLEGIA 31, AUTOSOMAL DOMINANT
PIGM	糖基化磷脂酰肌醇缺乏症	GLYCOSYLPHOSPHATIDYLINOSITOL DEFICIENCY
CHRNB2	癫痫	EPILEPSY, NOCTURNAL FRONTAL LOBE, 4
KIF1A	遗传性痉挛性截瘫	SPASTIC PARAPLEGIA 30, AUTOSOMAL RECESSIVE
SNRNP200	视网膜色素变性	RETINITIS PIGMENTOSA 33
NEUROG3	腹泻	DIARRHEA 4, MALABSORPTIVE, CONGENITAL
ABCC8	新生儿暂时性糖尿病	DIABETES MELLITUS, TRANSIENT NEONATAL, 2
CABP4	先天性静止性夜盲症	NIGHT BLINDNESS, CONGENITAL STATIONARY, TYPE 2B
STAT5B	染色体缺失综合征	KOOLEN-DE VRIES SYNDROME
KANSL1	染色体缺失综合征	KOOLEN-DE VRIES SYNDROME
SAMD9	肿瘤样钙沉着症	TUMORAL CALCINOSIS, NORMOPHOSPHATEMIC, FAMILIAL
DSC2	致心律失常性右室心肌病	ARRHYTHMOGENIC RIGHT VENTRICULAR DYSPLASIA, FAMILIAL, 11
CACNA2D4	视锥细胞营养不良	RETINAL CONE DYSTROPHY 4
PRKAR1A	原发性色素性结节状肾上腺皮质病	PIGMENTED NODULAR ADRENOCORTICAL DISEASE, PRIMARY, 1
EFTUD2	小头畸形	MANDIBULOFACIAL DYSOSTOSIS, GUION-ALMEIDA TYPE
GFPT1	肌无力综合征	MYASTHENIC SYNDROME, CONGENITAL, WITH TUBULAR AGGREGATES 1
INSR	二型糖尿病合并黑棘皮症	DIABETES MELLITUS, INSULIN-RESISTANT, WITH ACANTHOSIS NIGRICANS
RD3	莱伯氏先天性黑矇	LEBER CONGENITAL AMAUROSIS 12
PITX3	白内障	CATARACT 11, MULTIPLE TYPES
RSPO1	46,性反转	PALMOPLANTAR HYPERKERATOSIS WITH SQUAMOUS CELL CARCINOMA OF SKIN AND
ERCC3	着色性干皮病	XERODERMA PIGMENTOSUM, COMPLEMENTATION GROUP B
TMEM67	朱伯特综合征	JOUBERT SYNDROME 6
FGF3	先天性耳聋	DEAFNESS, CONGENITAL, WITH INNER EAR AGENESIS, MICROTIA, AND MICRODONTIA
ERCC1	脑额骨综合征	CEREBROOCULOFACIOSKELETAL SYNDROME 4
LAMTOR2	免疫缺陷	IMMUNODEFICIENCY DUE TO DEFECT IN MAPBP-INTERACTING PROTEIN
PTCH1	前脑无裂畸形	HOLOPROSENCEPHALY 7
GLI2	前脑无裂畸形	HOLOPROSENCEPHALY 9
GGCX	弹性假黄瘤	PSEUDOXANTHOMA ELASTICUM-LIKE DISORDER WITH MULTIPLE COAGULATION FACTOR
LRP6	冠状动脉疾病	CORONARY ARTERY DISEASE, AUTOSOMAL DOMINANT 2
ERCC4	XFE早衰样综合征	XFE PROGEROID SYNDROME
IFITM5	成骨不全症	OSTEOGENESIS IMPERFECTA, TYPE V
NKX2-1	舞蹈手足徐动症,甲状腺机能减退伴新生儿呼吸窘迫综合征	CHOREOATHETOSIS AND CONGENITAL HYPOTHYROIDISM WITH OR WITHOUT PULMONARY
CFI	补体因子缺乏症	COMPLEMENT FACTOR I DEFICIENCY
RDX	先天性耳聋	DEAFNESS, AUTOSOMAL RECESSIVE 24
MFRP	孤立型小眼畸形	MICROPHTHALMIA, ISOLATED 5
ST3GAL3	智力低下	MENTAL RETARDATION, AUTOSOMAL RECESSIVE 12
NSUN2	智力低下	MENTAL RETARDATION, AUTOSOMAL RECESSIVE 5
TUSC3	智力低下	MENTAL RETARDATION, AUTOSOMAL RECESSIVE 7
CEP290	Meckel综合征	MECKEL SYNDROME, TYPE 4
IRX5	HAMAMY综合征	HAMAMY SYNDROME
ERLIN2	遗传性痉挛性截瘫	SPASTIC PARAPLEGIA 18, AUTOSOMAL RECESSIVE
IFT80	窒息性胸廓发育不良	SHORT-RIB THORACIC DYSPLASIA 2 WITH OR WITHOUT POLYDACTYLY
TBX20	房间隔缺损	ATRIAL SEPTAL DEFECT 4
DFNB31	尤塞氏综合症	USHER SYNDROME, TYPE IID
LRTOMT	先天性耳聋	DEAFNESS, AUTOSOMAL RECESSIVE 63
PLEKHM1	骨硬化病	OSTEOPETROSIS, AUTOSOMAL RECESSIVE 6
TYK2	免疫缺陷	IMMUNODEFICIENCY 35
JUP	致心律失常性右室心肌病	ARRHYTHMOGENIC RIGHT VENTRICULAR DYSPLASIA, FAMILIAL, 12
CRYBB1	白内障	CATARACT 17, MULTIPLE TYPES
NOBOX	卵巢早衰	PREMATURE OVARIAN FAILURE 5
RPGRIP1L	朱伯特综合征	JOUBERT SYNDROME 7
RPGRIP1L	Meckel综合征	MECKEL SYNDROME, TYPE 5
PSAP	saposin缺乏病	COMBINED SAPOSIN DEFICIENCY
PSAP	Krabbe病	KRABBE DISEASE, ATYPICAL, DUE TO SAPOSIN A DEFICIENCY
CEP290	莱伯氏先天性黑矇	LEBER CONGENITAL AMAUROSIS 10
CACNA1C	Brugada综合征	BRUGADA SYNDROME 4
RNF168	Riddle综合征	RIDDLE SYNDROME
CYCS	血小板减少症	THROMBOCYTOPENIA 4
RRM2B	线粒体DNA缺失综合征	MITOCHONDRIAL DNA DEPLETION SYNDROME 8A (ENCEPHALOMYOPATHIC TYPE WITH
PROM1	视网膜色素变性	RETINITIS PIGMENTOSA 41
PLEC	单纯型大疱性表皮松解症	EPIDERMOLYSIS BULLOSA SIMPLEX WITH PYLORIC ATRESIA
CTC1	脑视网膜微血管病变,钙化和囊肿	CEREBRORETINAL MICROANGIOPATHY WITH CALCIFICATIONS AND CYSTS
NPPA	心房颤动	ATRIAL FIBRILLATION, FAMILIAL, 6
MYD88	髓样分化因子88缺乏症	MYD88 DEFICIENCY
CD59	CD59缺乏症	HEMOLYTIC ANEMIA, CD59-MEDIATED, WITH OR WITHOUT IMMUNE-MEDIATED POLYNEUROPATHY
FA2H	遗传性痉挛性截瘫	SPASTIC PARAPLEGIA 35, AUTOSOMAL RECESSIVE
SRD5A3	先天性糖基化障碍	CONGENITAL DISORDER OF GLYCOSYLATION, TYPE Iq
C6	补体成分缺乏症	COMPLEMENT COMPONENT 6 DEFICIENCY
GNAS	假性甲状旁腺功能减退症	PSEUDOHYPOPARATHYROIDISM, TYPE IC
DNAAF2	原发性纤毛运动障碍	CILIARY DYSKINESIA, PRIMARY, 10
HNF1A	胰岛素依赖型糖尿病	DIABETES MELLITUS, INSULIN-DEPENDENT, 20
MMP20	牙釉质发育不全	AMELOGENESIS IMPERFECTA, HYPOMATURATION TYPE, IIA2
SLC33A1	遗传性痉挛性截瘫	SPASTIC PARAPLEGIA 42, AUTOSOMAL DOMINANT
CNTN1	先天性肌病	MYOPATHY, CONGENITAL, COMPTON-NORTH
KIRREL3	智力低下	MENTAL RETARDATION, AUTOSOMAL DOMINANT 4
RSPH9	原发性纤毛运动障碍	CILIARY DYSKINESIA, PRIMARY, 12
ABHD12	多神经病,听力丧失,共济失调,视网膜色素变性,白内障	POLYNEUROPATHY, HEARING LOSS, ATAXIA, RETINITIS PIGMENTOSA, AND CATARACT
SRD5A3	KAHRIZI综合征	KAHRIZI SYNDROME
GH1	单一性生长素缺乏症	ISOLATED GROWTH HORMONE DEFICIENCY, TYPE IB
ACTC1	房间隔缺损	ATRIAL SEPTAL DEFECT 5
LDHA	糖原贮积症	GLYCOGEN STORAGE DISEASE XI
PGM1	糖原贮积症	GLYCOGEN STORAGE DISEASE XIV
RNASET2	脑白质病	LEUKOENCEPHALOPATHY, CYSTIC, WITHOUT MEGALENCEPHALY
BAG3	肌纤维肌病	MYOPATHY, MYOFIBRILLAR, 6
CATSPER1	生精障碍	SPERMATOGENIC FAILURE 7
SCNN1G	支气管扩张	BRONCHIECTASIS WITH OR WITHOUT ELEVATED SWEAT CHLORIDE 3
DYNC2H1	窒息性胸廓发育不良	SHORT-RIB THORACIC DYSPLASIA 3 WITH OR WITHOUT POLYDACTYLY
STXBP2	噬血细胞性淋巴组织细胞增多症	HEMOPHAGOCYTIC LYMPHOHISTIOCYTOSIS, FAMILIAL, 5
HCN4	Brugada综合征	BRUGADA SYNDROME 8
LARGE	肌营养不良-抗肌萎缩相关糖蛋白病	MUSCULAR DYSTROPHY-DYSTROGLYCANOPATHY (CONGENITAL WITH BRAIN AND EYE
POMT2	肌营养不良-抗肌萎缩相关糖蛋白病	MUSCULAR DYSTROPHY-DYSTROGLYCANOPATHY (CONGENITAL WITH MENTAL RETARDATION),
POMT2	肌营养不良-抗肌萎缩相关糖蛋白病	MUSCULAR DYSTROPHY-DYSTROGLYCANOPATHY (LIMB-GIRDLE), TYPE C, 2
ABAT	转移酶缺乏症	GABA-TRANSAMINASE DEFICIENCY
WDR72	牙釉质发育不全	AMELOGENESIS IMPERFECTA, HYPOMATURATION TYPE, IIA3
EPCAM	腹泻	DIARRHEA 5, WITH TUFTING ENTEROPATHY, CONGENITAL
NRAS	努南综合征	NOONAN SYNDROME 6
SLITRK1	拔毛症	TRICHOTILLOMANIA
NKX3-2	脊椎干骺端发育不良	SPONDYLO-MEGAEPIPHYSEAL-METAPHYSEAL DYSPLASIA
LRAT	莱伯氏先天性黑矇	LEBER CONGENITAL AMAUROSIS 14
BLK	青年发病的成年型糖尿病	MATURITY-ONSET DIABETES OF THE YOUNG, TYPE 11
HSPB3	远端遗传性运动神经元病	NEURONOPATHY, DISTAL HEREDITARY MOTOR, TYPE IIC
PTHLH	短指症	BRACHYDACTYLY, TYPE E2
ITCH	自身免疫性疾病	AUTOIMMUNE DISEASE, MULTISYSTEM, WITH FACIAL DYSMORPHISM
SLC34A1	范可尼综合征	FANCONI RENOTUBULAR SYNDROME 2
VIPAR	关节挛缩肾功能障碍与胆汁淤积	ARTHROGRYPOSIS, RENAL DYSFUNCTION, AND CHOLESTASIS 2
SPTAN1	癫痫	EPILEPTIC ENCEPHALOPATHY, EARLY INFANTILE, 5
CD19	常见变异型免疫缺陷病	IMMUNODEFICIENCY, COMMON VARIABLE, 3
WDR35	颅骨外胚层发育不良	CRANIOECTODERMAL DYSPLASIA 2
KCNJ5	家族性高醛甾酮症	HYPERALDOSTERONISM, FAMILIAL, TYPE III
ATL1	感觉自主神经病	NEUROPATHY, HEREDITARY SENSORY, TYPE ID
AP4E1	遗传性痉挛性截瘫	SPASTIC PARAPLEGIA 51, AUTOSOMAL RECESSIVE
ACVR2B	内脏异位	HETEROTAXY, VISCERAL, 4, AUTOSOMAL
AHCY	高蛋氨酸血症	HYPERMETHIONINEMIA WITH S-ADENOSYLHOMOCYSTEINE HYDROLASE DEFICIENCY
FADD	反复感染伴脑病,肝功能异常和心血管畸形	INFECTIONS, RECURRENT, WITH ENCEPHALOPATHY, HEPATIC DYSFUNCTION, AND
MAP3K1	46,性反转	46,XY SEX REVERSAL 6
CRYAB	白内障	CATARACT 16, MULTIPLE TYPES
TTN	家族性肥厚型心肌病	CARDIOMYOPATHY, FAMILIAL HYPERTROPHIC, 9
MYLK	主动脉瘤	AORTIC ANEURYSM, FAMILIAL THORACIC 7
C1S	补体因子缺乏症	COMPLEMENT COMPONENT C1s DEFICIENCY
C8A	补体成分缺乏症	COMPLEMENT COMPONENT 8 DEFICIENCY, TYPE I
SMAD3	Loeys-Dietz综合征	LOEYS-DIETZ SYNDROME 3
ORC4	Meier-Gorlin综合征	MEIER-GORLIN SYNDROME 2
ORC6	Meier-Gorlin综合征	MEIER-GORLIN SYNDROME 3
CDT1	Meier-Gorlin综合征	MEIER-GORLIN SYNDROME 4
CDC6	Meier-Gorlin综合征	MEIER-GORLIN SYNDROME 5
CCDC39	原发性纤毛运动障碍	CILIARY DYSKINESIA, PRIMARY, 14
CCDC40	原发性纤毛运动障碍	CILIARY DYSKINESIA, PRIMARY, 15
SEPSECS	脑桥小脑发育不全	PONTOCEREBELLAR HYPOPLASIA, TYPE 2D
CYP7B1	先天性胆汁酸合成缺陷	BILE ACID SYNTHESIS DEFECT, CONGENITAL, 3
DAG1	肌营养不良-抗肌萎缩相关糖蛋白病	MUSCULAR DYSTROPHY-DYSTROGLYCANOPATHY (LIMB-GIRDLE), TYPE C, 9
TTC21B	窒息性胸廓发育不良	SHORT-RIB THORACIC DYSPLASIA 4 WITH OR WITHOUT POLYDACTYLY
TTC21B	肾消耗病	NEPHRONOPHTHISIS 12
CEP152	Seckel综合征	SECKEL SYNDROME 5
NEK8	肾消耗病	NEPHRONOPHTHISIS 9
C9	补体因子缺乏症	COMPLEMENT COMPONENT 9 DEFICIENCY
RPGRIP1	莱伯氏先天性黑矇	LEBER CONGENITAL AMAUROSIS 6
CRX	莱伯氏先天性黑矇	LEBER CONGENITAL AMAUROSIS 7
SLC24A1	先天性静止性夜盲症	NIGHT BLINDNESS, CONGENITAL STATIONARY, TYPE 1D
ACTA2	多系统平滑肌功能障碍综合征	MULTISYSTEMIC SMOOTH MUSCLE DYSFUNCTION SYNDROME
CRB1	莱伯氏先天性黑矇	LEBER CONGENITAL AMAUROSIS 8
DHFR	巨幼细胞性贫血	MEGALOBLASTIC ANEMIA DUE TO DIHYDROFOLATE REDUCTASE DEFICIENCY
TULP1	莱伯氏先天性黑矇	LEBER CONGENITAL AMAUROSIS 15
SARS2	高尿酸血症,肺高血压,肾功能衰竭和碱中毒	HYPERURICEMIA, PULMONARY HYPERTENSION, RENAL FAILURE, AND ALKALOSIS
FUT6	转移酶缺乏症	FUCOSYLTRANSFERASE 6 DEFICIENCY
SCN9A	全身性癫痫伴热性惊厥附加症	GENERALIZED EPILEPSY WITH FEBRILE SEIZURES PLUS, TYPE 7
SLC26A5	先天性耳聋	DEAFNESS, AUTOSOMAL RECESSIVE 61
CRYAB	α-B晶状体相关的致命的小儿高渗肌纤维肌病	MYOPATHY, MYOFIBRILLAR, FATAL INFANTILE HYPERTONIC, ALPHA-B CRYSTALLIN-RELATED
ECE1	先天性巨结肠症,心脏缺陷和植物神经功能紊乱	HIRSCHSPRUNG DISEASE, CARDIAC DEFECTS, AND AUTONOMIC DYSFUNCTION
PLIN1	局部脂肪营养不良	LIPODYSTROPHY, FAMILIAL PARTIAL, TYPE 4
BAG3	扩张型心肌病	CARDIOMYOPATHY, DILATED, 1HH
CNNM2	低镁血症	HYPOMAGNESEMIA 6, RENAL
TCTN2	Meckel综合征	MECKEL SYNDROME, TYPE 8
NTRK2	肥胖,饮食过量和发育延迟	OBESITY, HYPERPHAGIA, AND DEVELOPMENTAL DELAY
TDRD7	白内障	CATARACT 36
CFD	补体因子缺乏症	COMPLEMENT FACTOR D DEFICIENCY
IL17RA	念珠菌病	CANDIDIASIS, FAMILIAL, 5
VCP	肌萎缩侧索硬化	AMYOTROPHIC LATERAL SCLEROSIS 14 WITH OR WITHOUT FRONTOTEMPORAL DEMENTIA
IL31RA	淀粉样变性	AMYLOIDOSIS, PRIMARY LOCALIZED CUTANEOUS, 2
IL17F	念珠菌病	CANDIDIASIS, FAMILIAL, 6
NR5A1	生精障碍	SPERMATOGENIC FAILURE 8
DPY19L2	生精障碍	SPERMATOGENIC FAILURE 9
NCF4	慢性肉芽肿病	GRANULOMATOUS DISEASE, CHRONIC, AUTOSOMAL RECESSIVE, CYTOCHROME b-POSITIVE,
GRIN2B	智力低下	MENTAL RETARDATION, AUTOSOMAL DOMINANT 6
GRIN2A	癫痫伴神经发育缺陷	EPILEPSY WITH NEURODEVELOPMENTAL DEFECTS
HBG2	暂时性新生儿紫绀	CYANOSIS, TRANSIENT NEONATAL
HBA1	血红蛋白H病	HEMOGLOBIN H DISEASE
HBA2	血红蛋白H病	HEMOGLOBIN H DISEASE
KCNJ2	心房颤动	ATRIAL FIBRILLATION, FAMILIAL, 9
OTX2	联合性垂体激素缺乏症	PITUITARY HORMONE DEFICIENCY, COMBINED, 6
TERT	先天性角化不良	DYSKERATOSIS CONGENITA, AUTOSOMAL DOMINANT, 2
TINF2	先天性角化不良	DYSKERATOSIS CONGENITA, AUTOSOMAL DOMINANT, 3
BANF1	Nestor-Guillermo早衰综合征	NESTOR-GUILLERMO PROGERIA SYNDROME
DNAL1	原发性纤毛运动障碍	CILIARY DYSKINESIA, PRIMARY, 16
GOSR2	癫痫	EPILEPSY, PROGRESSIVE MYOCLONIC, 6
NDE1	无脑回畸形	LISSENCEPHALY 4
TECR	智力低下	MENTAL RETARDATION, AUTOSOMAL RECESSIVE 14
SCN5A	心房颤动	ATRIAL FIBRILLATION, FAMILIAL, 10
PSPH	水解酶缺乏症	PHOSPHOSERINE PHOSPHATASE DEFICIENCY
PROZ	蛋白Z缺失	PROTEIN Z DEFICIENCY
LIPC	水解酶缺乏症	HEPATIC LIPASE DEFICIENCY
APOC3	高α脂蛋白血症	APOLIPOPROTEIN C-III DEFICIENCY
HMOX1	氧化还原酶缺乏症	HEME OXYGENASE 1 DEFICIENCY
CLDN14	先天性耳聋	DEAFNESS, AUTOSOMAL RECESSIVE 29
GATA2	原发性淋巴水肿伴骨髓增生异常	LYMPHEDEMA, PRIMARY, WITH MYELODYSPLASIA
TUBB3	复杂的皮质发育不良伴其他脑畸形	CORTICAL DYSPLASIA, COMPLEX, WITH OTHER BRAIN MALFORMATIONS 1
ACTA2	烟雾病	MOYAMOYA DISEASE 5
GJA5	心房颤动	ATRIAL FIBRILLATION, FAMILIAL, 11
ABCC9	心房颤动	ATRIAL FIBRILLATION, FAMILIAL, 12
ATP5E	线粒体复合物缺乏症	MITOCHONDRIAL COMPLEX V (ATP SYNTHASE) DEFICIENCY, NUCLEAR TYPE 3
NAT8L	N-乙酰天冬氨酸缺乏症	N-ACETYLASPARTATE DEFICIENCY
FLNC	远端肌病	MYOPATHY, DISTAL, 4
AP4B1	遗传性痉挛性截瘫	SPASTIC PARAPLEGIA 47, AUTOSOMAL RECESSIVE
AP4S1	遗传性痉挛性截瘫	SPASTIC PARAPLEGIA 52, AUTOSOMAL RECESSIVE
ZBTB24	免疫缺陷-着丝粒不稳定-面部异常综合征	IMMUNODEFICIENCY-CENTROMERIC INSTABILITY-FACIAL ANOMALIES SYNDROME
HPS3	Hermansky-Pudlak综合征	HERMANSKY-PUDLAK SYNDROME 3
HPS4	Hermansky-Pudlak综合征	HERMANSKY-PUDLAK SYNDROME 4
HPS5	Hermansky-Pudlak综合征	HERMANSKY-PUDLAK SYNDROME 5
HPS6	Hermansky-Pudlak综合征	HERMANSKY-PUDLAK SYNDROME 6
DTNBP1	Hermansky-Pudlak综合征	HERMANSKY-PUDLAK SYNDROME 7
BLOC1S3	Hermansky-Pudlak综合征	HERMANSKY-PUDLAK SYNDROME 8
IMPAD1	软骨发育不全	CHONDRODYSPLASIA WITH JOINT DISLOCATIONS, GPAPP TYPE
PIGN	多发性先天异常-肌张力低下-癫痫综合征	MULTIPLE CONGENITAL ANOMALIES-HYPOTONIA-SEIZURES SYNDROME 1
HP	缺结合珠蛋白血症	ANHAPTOGLOBINEMIA
MYH6	房间隔缺损	ATRIAL SEPTAL DEFECT 3
WDR35	窒息性胸廓发育不良	SHORT-RIB THORACIC DYSPLASIA 7 WITH OR WITHOUT POLYDACTYLY
AARS2	组合型氧化磷酸化缺陷症	COMBINED OXIDATIVE PHOSPHORYLATION DEFICIENCY 8
CAT	缺触酶血症	ACATALASEMIA
IFT43	颅骨外胚层发育不良	CRANIOECTODERMAL DYSPLASIA 3
ALDH6A1	氧化还原酶缺乏症	METHYLMALONATE SEMIALDEHYDE DEHYDROGENASE DEFICIENCY
PDHB	氧化还原酶缺乏症	PYRUVATE DEHYDROGENASE E1-BETA DEFICIENCY
CEP57	斑花叶非整倍体综合征	MOSAIC VARIEGATED ANEUPLOIDY SYNDROME 2
LAMC3	枕叶皮层畸形	CORTICAL MALFORMATIONS, OCCIPITAL
DNMT1	感觉自主神经病	NEUROPATHY, HEREDITARY SENSORY, TYPE IE
KIF7	HYDROLETHALUS综合征	HYDROLETHALUS SYNDROME 2
CHIT1	壳三糖苷酶缺乏症	CHITOTRIOSIDASE DEFICIENCY
LDHB	氧化还原酶缺乏症	LACTATE DEHYDROGENASE B DEFICIENCY
MYO1E	局灶性节段性肾小球硬化症	FOCAL SEGMENTAL GLOMERULOSCLEROSIS 6
TMCO1	颅面异形,骨骼畸形和智力低下综合征	CRANIOFACIAL DYSMORPHISM, SKELETAL ANOMALIES, AND MENTAL RETARDATION
COL9A1	斯蒂克勒综合征	STICKLER SYNDROME, TYPE IV
COL9A1	多发性骨骺发育不良	EPIPHYSEAL DYSPLASIA, MULTIPLE, 6
DIABLO	先天性耳聋	DEAFNESS, AUTOSOMAL DOMINANT 64
BLVRA	高胆绿素血症	HYPERBILIVERDINEMIA
FZD6	非综合征性先天性指甲障碍	NAIL DISORDER, NONSYNDROMIC CONGENITAL, 10
MSTN	肌肉肥大	MUSCLE HYPERTROPHY
STAT1	免疫缺陷	IMMUNODEFICIENCY 31C
SDHA	副神经节瘤	PARAGANGLIOMAS 5
PRDM5	角膜脆弱综合征	BRITTLE CORNEA SYNDROME 2
PLDN	Hermansky-Pudlak综合征	HERMANSKY-PUDLAK SYNDROME 9
GATA2	免疫缺陷	IMMUNODEFICIENCY 21
B9D2	Meckel综合征	MECKEL SYNDROME, TYPE 10
FBN1	Geleophysic发育不良	GELEOPHYSIC DYSPLASIA 2
KCNJ13	莱伯氏先天性黑矇	LEBER CONGENITAL AMAUROSIS 16
IL11RA	颅缝早闭症及牙齿异常	CRANIOSYNOSTOSIS AND DENTAL ANOMALIES
RNF135	大头畸形综合征	MACROCEPHALY, MACROSOMIA, AND FACIAL DYSMORPHISM SYNDROME
VSX1	颅面异常和前节发育不全综合征	CRANIOFACIAL ANOMALIES AND ANTERIOR SEGMENT DYSGENESIS SYNDROME
PTPRO	肾病综合征	NEPHROTIC SYNDROME, TYPE 6
SCN4A	肌无力综合征	MYASTHENIC SYNDROME, CONGENITAL, ACETAZOLAMIDE-RESPONSIVE
LAMB2	肾病综合征	NEPHROTIC SYNDROME, TYPE 5, WITH OR WITHOUT OCULAR ABNORMALITIES
GP6	出血性疾病	BLEEDING DISORDER, PLATELET-TYPE, 11
MAN1B1	智力低下	MENTAL RETARDATION, AUTOSOMAL RECESSIVE 15
VPS35	遗传性帕金森病	PARKINSON DISEASE 17
IL36RN	银屑病	PSORIASIS 14, PUSTULAR
CCDC8	3M综合征	THREE M SYNDROME 3
B9D1	Meckel综合征	MECKEL SYNDROME, TYPE 9
DOCK6	Adams-Oliver综合征	ADAMS-OLIVER SYNDROME 2
RAB18	脑积水,无脑回和视网膜发育不全综合征	WARBURG MICRO SYNDROME 3
IGFBP7	视网膜大动脉瘤伴瓣上肺动脉瓣狭窄	RETINAL ARTERIAL MACROANEURYSM WITH SUPRAVALVULAR PULMONIC STENOSIS
RAB3GAP2	脑积水,无脑回和视网膜发育不全综合征	WARBURG MICRO SYNDROME 2
CDON	前脑无裂畸形	HOLOPROSENCEPHALY 11
DYNC1H1	腓骨肌萎缩症	CHARCOT-MARIE-TOOTH DISEASE, AXONAL, TYPE 2O
SYT14	脊髓小脑性共济失调	SPINOCEREBELLAR ATAXIA, AUTOSOMAL RECESSIVE 11
IER3IP1	小头畸形	MICROCEPHALY, EPILEPSY, AND DIABETES SYNDROME
MED23	智力低下	MENTAL RETARDATION, AUTOSOMAL RECESSIVE 18
MOG	发作性睡病	NARCOLEPSY 7
EIF4G1	遗传性帕金森病	PARKINSON DISEASE 18
FAM20A	牙釉质发育不全综合征伴牙龈纤维瘤病	AMELOGENESIS IMPERFECTA AND GINGIVAL FIBROMATOSIS SYNDROME
GRIN1	智力低下	MENTAL RETARDATION, AUTOSOMAL DOMINANT 8
KIF1A	智力低下	MENTAL RETARDATION, AUTOSOMAL DOMINANT 9
CACNG2	智力低下	MENTAL RETARDATION, AUTOSOMAL DOMINANT 10
EPB41L1	智力低下	MENTAL RETARDATION, AUTOSOMAL DOMINANT 11
ACSF3	甲基丙二酸尿症	COMBINED MALONIC AND METHYLMALONIC ACIDURIA
MSR1	Barrett食管	BARRETT ESOPHAGUS
ASCC1	Barrett食管	BARRETT ESOPHAGUS
CTHRC1	Barrett食管	BARRETT ESOPHAGUS
PLA2G7	水解酶缺乏症	PLATELET-ACTIVATING FACTOR ACETYLHYDROLASE DEFICIENCY
AKR1C2	46,性反转	46,XY SEX REVERSAL 8
COL9A2	斯蒂克勒综合征	STICKLER SYNDROME, TYPE V
LEPREL1	近视	MYOPIA, HIGH, WITH CATARACT AND VITREORETINAL DEGENERATION
C6orf221	复发性葡萄胎	HYDATIDIFORM MOLE, RECURRENT, 2
WFS1	Wolfram综合征	WOLFRAM-LIKE SYNDROME, AUTOSOMAL DOMINANT
C19orf12	大脑铁沉积性神经退行性变	NEURODEGENERATION WITH BRAIN IRON ACCUMULATION 4
BOLA3	多线粒体功能障碍综合征	MULTIPLE MITOCHONDRIAL DYSFUNCTIONS SYNDROME 2
ADK	高蛋氨酸血症	HYPERMETHIONINEMIA DUE TO ADENOSINE KINASE DEFICIENCY
LRP4	硬化性骨化病	SCLEROSTEOSIS 2
AMACR	异构酶缺乏症	ALPHA-METHYLACYL-CoA RACEMASE DEFICIENCY
CAV3	远端肌病	MYOPATHY, DISTAL, TATEYAMA TYPE
PSMC3IP	卵巢发育不良	OVARIAN DYSGENESIS 3
NRXN1	皮特-霍普金斯综合征	PITT-HOPKINS-LIKE SYNDROME 2
BAP1	肿瘤易感综合症	TUMOR PREDISPOSITION SYNDROME
ADAM17	新生儿炎症性皮肤病和肠道疾病	INFLAMMATORY SKIN AND BOWEL DISEASE, NEONATAL, 1
NRXN1	精神分裂症	CHROMOSOME 2p16.3 DELETION SYNDROME
MYBPC1	远端关节弯曲	ARTHROGRYPOSIS, DISTAL, TYPE 1B
MSH6	大肠癌	COLORECTAL CANCER, HEREDITARY NONPOLYPOSIS, TYPE 5
MYH14	周围神经病变导致肌病,声音嘶哑以及听力损失	PERIPHERAL NEUROPATHY, MYOPATHY, HOARSENESS, AND HEARING LOSS
CSF2RB	肺表面活性物质代谢功能障碍	SURFACTANT METABOLISM DYSFUNCTION, PULMONARY, 5
SIGMAR1	肌萎缩侧索硬化	AMYOTROPHIC LATERAL SCLEROSIS 16, JUVENILE
WDR19	窒息性胸廓发育不良	SHORT-RIB THORACIC DYSPLASIA 5 WITH OR WITHOUT POLYDACTYLY
WDR19	肾消耗病	NEPHRONOPHTHISIS 13
WDR19	颅骨外胚层发育不良	CRANIOECTODERMAL DYSPLASIA 4
C4B	补体成分缺乏症	COMPLEMENT COMPONENT 4B DEFICIENCY
C4A	补体成分缺乏症	COMPLEMENT COMPONENT 4A DEFICIENCY
POLR3B	脑白质营养不良伴髓鞘发育不良	LEUKODYSTROPHY, HYPOMYELINATING, 8, WITH OR WITHOUT OLIGODONTIA AND/OR
MLH3	大肠癌	COLORECTAL CANCER, HEREDITARY NONPOLYPOSIS, TYPE 7
DNM1L	缺陷的线粒体和过氧化物酶体裂变导致的致死性脑病	ENCEPHALOPATHY, LETHAL, DUE TO DEFECTIVE MITOCHONDRIAL AND PEROXISOMAL
MEGF10	早发性肌病导致反射消失,呼吸窘迫和吞咽困难	MYOPATHY, AREFLEXIA, RESPIRATORY DISTRESS, AND DYSPHAGIA, EARLY-ONSET
VAX1	小眼畸形综合征	MICROPHTHALMIA, SYNDROMIC 11
CYP26B1	与其他骨骼和颅面畸形的RADIOHUMERAL融合	RADIOHUMERAL FUSIONS WITH OTHER SKELETAL AND CRANIOFACIAL ANOMALIES
CPA6	家族性颞叶癫痫	EPILEPSY, FAMILIAL TEMPORAL LOBE, 5
DNASE1L3	系统性红斑狼疮	SYSTEMIC LUPUS ERYTHEMATOSUS 16
TMEM237	朱伯特综合征	JOUBERT SYNDROME 14
GATA4	室间隔缺损	VENTRICULAR SEPTAL DEFECT 1
GATA4	房室隔缺损	ATRIOVENTRICULAR SEPTAL DEFECT 4
NKX2-5	室间隔缺损	VENTRICULAR SEPTAL DEFECT 3
LRSAM1	腓骨肌萎缩症	CHARCOT-MARIE-TOOTH DISEASE, AXONAL, TYPE 2P
SLCO2A1	原发性肥大性骨关节病	HYPERTROPHIC OSTEOARTHROPATHY, PRIMARY, AUTOSOMAL RECESSIVE, 2
THRA	甲状腺功能减退症	HYPOTHYROIDISM, CONGENITAL, NONGOITROUS, 6
INF2	腓骨肌萎缩症	CHARCOT-MARIE-TOOTH DISEASE, DOMINANT INTERMEDIATE E
ELOVL4	鱼鳞病	ICHTHYOSIS, SPASTIC QUADRIPLEGIA, AND MENTAL RETARDATION
TPK1	硫胺素代谢障碍综合征	THIAMINE METABOLISM DYSFUNCTION SYNDROME 5 (EPISODIC ENCEPHALOPATHY
LIAS	氧化还原酶缺乏症	PYRUVATE DEHYDROGENASE LIPOIC ACID SYNTHETASE DEFICIENCY
CEP41	朱伯特综合征	JOUBERT SYNDROME 15
TMEM138	朱伯特综合征	JOUBERT SYNDROME 16
NRAS	自身免疫性淋巴细胞增生综合征	RAS-ASSOCIATED AUTOIMMUNE LEUKOPROLIFERATIVE DISORDER
ABCC6	婴儿期特发性动脉钙化	ARTERIAL CALCIFICATION, GENERALIZED, OF INFANCY, 2
GATA6	房室隔缺损	ATRIOVENTRICULAR SEPTAL DEFECT 5
GPD1	新生儿暂时性高甘油三酯血症	HYPERTRIGLYCERIDEMIA, TRANSIENT INFANTILE
SLC33A1	先天性白内障	CONGENITAL CATARACTS, HEARING LOSS, AND NEURODEGENERATION
COL4A2	家族性孔洞脑	PORENCEPHALY 2
FREM1	三角头(畸形)	TRIGONOCEPHALY 2
AFG3L2	痉挛性共济失调	SPASTIC ATAXIA 5, AUTOSOMAL RECESSIVE
WNK4	假性醛固酮过少症	PSEUDOHYPOALDOSTERONISM, TYPE IIB
WIPF1	维-奥二氏综合征	WISKOTT-ALDRICH SYNDROME 2
KLHL3	假性醛固酮过少症	PSEUDOHYPOALDOSTERONISM, TYPE IID
CUL3	假性醛固酮过少症	PSEUDOHYPOALDOSTERONISM, TYPE IIE
ABCB6	孤立型小眼畸形伴眼缺损	MICROPHTHALMIA, ISOLATED, WITH COLOBOMA 7
BRAT1	新生儿致命的刚性多病灶癫痫综合征	RIGIDITY AND MULTIFOCAL SEIZURE SYNDROME, LETHAL NEONATAL
C8orf37	锥杆营养不良	CONE-ROD DYSTROPHY 16
DDOST	先天性糖基化障碍	CONGENITAL DISORDER OF GLYCOSYLATION, TYPE Ir
RAD51	镜像动作	MIRROR MOVEMENTS 2
JAK2	特发性血小板增多症	THROMBOCYTHEMIA 3
COL11A2	短肢骨骼发育不全	FIBROCHONDROGENESIS 2
SLC20A2	基底核钙化症	BASAL GANGLIA CALCIFICATION, IDIOPATHIC, 3
FKBP14	Ehlers-Danlos综合征	EHLERS-DANLOS SYNDROME WITH PROGRESSIVE KYPHOSCOLIOSIS, MYOPATHY,
SCN8A	癫痫	EPILEPTIC ENCEPHALOPATHY, EARLY INFANTILE, 13
ACO2	视网膜变性	INFANTILE CEREBELLAR-RETINAL DEGENERATION
DYNC1H1	智力低下	MENTAL RETARDATION, AUTOSOMAL DOMINANT 13
ATR	家族性皮肤毛细血管扩张症和癌症综合征	CUTANEOUS TELANGIECTASIA AND CANCER SYNDROME, FAMILIAL
GPR179	先天性静止性夜盲症	NIGHT BLINDNESS, CONGENITAL STATIONARY, TYPE 1E
COG6	先天性糖基化障碍	CONGENITAL DISORDER OF GLYCOSYLATION, TYPE IIl
MRPL3	组合型氧化磷酸化缺陷症	COMBINED OXIDATIVE PHOSPHORYLATION DEFICIENCY 9
ACTG1	BARAITSER-WINTER综合征	BARAITSER-WINTER SYNDROME 2
TRPV3	掌跖角化病	PALMOPLANTAR KERATODERMA, MUTILATING, WITH PERIORIFICIAL KERATOTIC
SKIV2L	毛滴虫肝胆肠综合征	TRICHOHEPATOENTERIC SYNDROME 2
SMARCB1	智力低下	MENTAL RETARDATION, AUTOSOMAL DOMINANT 15
PDE4D	激素耐药的肢端骨发育不全	ACRODYSOSTOSIS 2 WITH OR WITHOUT HORMONE RESISTANCE
CEACAM16	先天性耳聋	DEAFNESS, AUTOSOMAL DOMINANT 4B
C5orf42	朱伯特综合征	JOUBERT SYNDROME 17
GUCY2C	腹泻	DIARRHEA 6
SLC6A5	过度惊骇	HYPEREKPLEXIA 3
GLRB	过度惊骇	HYPEREKPLEXIA 2
ISPD	肌营养不良-抗肌萎缩相关糖蛋白病	MUSCULAR DYSTROPHY-DYSTROGLYCANOPATHY (CONGENITAL WITH BRAIN AND EYE
COQ6	辅酶Q10缺陷症	COENZYME Q10 DEFICIENCY, PRIMARY, 6
COQ9	辅酶Q10缺陷症	COENZYME Q10 DEFICIENCY, PRIMARY, 5
GUCY2C	胎粪性肠梗阻	MECONIUM ILEUS
PLCB4	耳—髁状突综合征	AURICULOCONDYLAR SYNDROME 2
GATAD1	扩张型心肌病	CARDIOMYOPATHY, DILATED, 2B
CEP135	常染色体隐性遗传原发性小头畸形	MICROCEPHALY 8, PRIMARY, AUTOSOMAL RECESSIVE
SRP72	家族性骨髓造血功能衰竭	BONE MARROW FAILURE SYNDROME 1
EXOSC3	脑桥小脑发育不全	PONTOCEREBELLAR HYPOPLASIA, TYPE 1B
CCDC103	原发性纤毛运动障碍	CILIARY DYSKINESIA, PRIMARY, 17
CHMP2B	肌萎缩侧索硬化	AMYOTROPHIC LATERAL SCLEROSIS 17
CR2	常见变异型免疫缺陷病	IMMUNODEFICIENCY, COMMON VARIABLE, 7
LRBA	常见变异型免疫缺陷病	IMMUNODEFICIENCY, COMMON VARIABLE, 8, WITH AUTOIMMUNITY
RAD21	德朗热综合征	CORNELIA DE LANGE SYNDROME 4
MTO1	组合型氧化磷酸化缺陷症	COMBINED OXIDATIVE PHOSPHORYLATION DEFICIENCY 10
SLC52A2	Brown-Vialetto-vanLaere综合征	BROWN-VIALETTO-VAN LAERE SYNDROME 2
APRT	转移酶缺乏症	ADENINE PHOSPHORIBOSYLTRANSFERASE DEFICIENCY
TMEM165	先天性糖基化障碍	CONGENITAL DISORDER OF GLYCOSYLATION, TYPE IIk
CEP63	Seckel综合征	SECKEL SYNDROME 6
CDKN1C	胎儿宫内发育迟缓，干骺端发育不良，肾上腺发育不全	INTRAUTERINE GROWTH RETARDATION, METAPHYSEAL DYSPLASIA, ADRENAL HYPOPLASIA
NNT	糖皮质激素缺乏症	GLUCOCORTICOID DEFICIENCY 4
SERAC1	三甲基戊烯二酸尿症	3-@METHYLGLUTACONIC ACIDURIA WITH DEAFNESS, ENCEPHALOPATHY, AND LEIGH-LIKE
BRP44L	线粒体丙酮酸载体缺乏症	MITOCHONDRIAL PYRUVATE CARRIER DEFICIENCY
TERC	肺纤维化和/或骨髓衰竭	PULMONARY FIBROSIS AND/OR BONE MARROW FAILURE, TELOMERE-RELATED, 2
HOXB1	遗传性先天性面瘫	FACIAL PARESIS, HEREDITARY CONGENITAL, 3
ITGA3	先天性肺间质疾病,肾病综合征,大疱性表皮松解症	INTERSTITIAL LUNG DISEASE, NEPHROTIC SYNDROME, AND EPIDERMOLYSIS BULLOSA,
PIGO	高磷酸酯酶伴精神发育迟滞综合征	HYPERPHOSPHATASIA WITH MENTAL RETARDATION SYNDROME 2
DPAGT1	肌无力综合征	MYASTHENIC SYNDROME, CONGENITAL, WITH TUBULAR AGGREGATES 2
REEP1	远端遗传性运动神经元病	NEURONOPATHY, DISTAL HEREDITARY MOTOR, TYPE VB
NFIX	Sotos综合征	SOTOS SYNDROME 2
CCDC11	异位，内脏，常染色体	HETEROTAXY, VISCERAL, 6, AUTOSOMAL
FUS	遗传性特发性震颤	TREMOR, HEREDITARY ESSENTIAL, 4
PFN1	肌萎缩侧索硬化	AMYOTROPHIC LATERAL SCLEROSIS 18
CFHR5	CFHR5缺乏症	CFHR5 DEFICIENCY
POC1A	身材矮小症	SHORT STATURE, ONYCHODYSPLASIA, FACIAL DYSMORPHISM, AND HYPOTRICHOSIS
RBPJ	Adams-Oliver综合征	ADAMS-OLIVER SYNDROME 3
TGFB2	Loeys-Dietz综合征	LOEYS-DIETZ SYNDROME 4
FAN1	巨核间质肾病	INTERSTITIAL NEPHRITIS, KARYOMEGALIC
LTBP2	Weill-Marchesani综合征	WEILL-MARCHESANI SYNDROME 3
ATP1A3	儿童交替性偏瘫	ALTERNATING HEMIPLEGIA OF CHILDHOOD 2
SMAD6	主动脉瓣畸形	AORTIC VALVE DISEASE 2
KISS1R	低促性腺激素性性腺功能减退症	HYPOGONADOTROPIC HYPOGONADISM 8 WITH OR WITHOUT ANOSMIA
NELF	低促性腺激素性性腺功能减退症	HYPOGONADOTROPIC HYPOGONADISM 9 WITH OR WITHOUT ANOSMIA
TAC3	低促性腺激素性性腺功能减退症	HYPOGONADOTROPIC HYPOGONADISM 10 WITH OR WITHOUT ANOSMIA
TACR3	低促性腺激素性性腺功能减退症	HYPOGONADOTROPIC HYPOGONADISM 11 WITH OR WITHOUT ANOSMIA
GNRH1	低促性腺激素性性腺功能减退症	HYPOGONADOTROPIC HYPOGONADISM 12 WITH OR WITHOUT ANOSMIA
KISS1	低促性腺激素性性腺功能减退症	HYPOGONADOTROPIC HYPOGONADISM 13 WITH OR WITHOUT ANOSMIA
ZNF423	肾消耗病	NEPHRONOPHTHISIS 14
CEP164	肾消耗病	NEPHRONOPHTHISIS 15
BMP1	成骨不全症	OSTEOGENESIS IMPERFECTA, TYPE XIII
WDR11	低促性腺激素性性腺功能减退症	HYPOGONADOTROPIC HYPOGONADISM 14 WITH OR WITHOUT ANOSMIA
TSPEAR	先天性耳聋	DEAFNESS, AUTOSOMAL RECESSIVE 98
STK4	T细胞免疫缺陷,反复感染和自身免疫伴或不伴心脏畸形	T-CELL IMMUNODEFICIENCY, RECURRENT INFECTIONS, AND AUTOIMMUNITY WITH
HOXD13	VATER联合畸形	VATER ASSOCIATION
NF1	沃森综合征	WATSON SYNDROME
ENAM	牙釉质发育不全	AMELOGENESIS IMPERFECTA, TYPE IC
TBCE	Kenny-Caffey综合征	KENNY-CAFFEY SYNDROME, TYPE 1
CYB5A	高铁血红蛋白血症	METHEMOGLOBINEMIA TYPE IV
APOE	海蓝组织细胞增生症	SEA-BLUE HISTIOCYTE DISEASE
IGBP1	胼胝体发育不全,智力低下,眼部缺损和小颌畸形	CORPUS CALLOSUM, AGENESIS OF, WITH MENTAL RETARDATION, OCULAR COLOBOMA,
RPGR	锥杆营养不良	CONE-ROD DYSTROPHY, X-LINKED, 1
STAT3	高IgE反复感染综合征	HYPER-IgE RECURRENT INFECTION SYNDROME, AUTOSOMAL DOMINANT
USP9Y	生精障碍	SPERMATOGENIC FAILURE, Y-LINKED, 2
STRC	先天性耳聋	DEAFNESS, AUTOSOMAL RECESSIVE 16
GP1BA	伯-苏综合征	BERNARD-SOULIER SYNDROME, TYPE A2, AUTOSOMAL DOMINANT
SMPD1	尼曼-皮克病(鞘磷脂沉积病)	NIEMANN-PICK DISEASE, TYPE B
MYH8	远端关节弯曲	ARTHROGRYPOSIS, DISTAL, TYPE 7
NEFL	腓骨肌萎缩症	CHARCOT-MARIE-TOOTH DISEASE, DEMYELINATING, TYPE 1F
SGCE	肌张力障碍	MYOCLONIC DYSTONIA
CC2D1A	智力低下	MENTAL RETARDATION, AUTOSOMAL RECESSIVE 3
BMPR1A	息肉病综合征	POLYPOSIS SYNDROME, HEREDITARY MIXED, 2
HOXD13	短指-并指畸形综合征	BRACHYDACTYLY-SYNDACTYLY SYNDROME
SMC3	德朗热综合征	CORNELIA DE LANGE SYNDROME 3
HMX1	眼-耳综合征	OCULOAURICULAR SYNDROME
C3	补体成分缺乏症	COMPLEMENT COMPONENT 3 DEFICIENCY, AUTOSOMAL RECESSIVE
C8B	补体因子缺乏症	COMPLEMENT COMPONENT 8 DEFICIENCY, TYPE II
TUBA8	多小脑回畸形	POLYMICROGYRIA WITH OPTIC NERVE HYPOPLASIA
DRD2	肌张力障碍	MYOCLONIC DYSTONIA
NF2	神经鞘瘤化	SCHWANNOMATOSIS 1
TNFRSF13C	常见变异型免疫缺陷病	IMMUNODEFICIENCY, COMMON VARIABLE, 4
MASP2 	MASP2缺陷	MASP2 DEFICIENCY
PRICKLE2	癫痫	EPILEPSY, PROGRESSIVE MYOCLONIC, 5
ATP1A2	儿童交替性偏瘫	ALTERNATING HEMIPLEGIA OF CHILDHOOD 1
TRPV4	类扭伤性侏儒	PARASTREMMATIC DWARFISM
SNCA	遗传性帕金森病	PARKINSON DISEASE 1, AUTOSOMAL DOMINANT
LRP5	全身性骨皮质增厚	ENDOSTEAL HYPEROSTOSIS, AUTOSOMAL DOMINANT
ENAM	牙釉质发育不全	AMELOGENESIS IMPERFECTA, TYPE IB
CST3	脑淀粉样血管病	CEREBRAL AMYLOID ANGIOPATHY, CST3-RELATED
SMAD4	幼年性息肉病/遗传性出血性毛细血管扩张症综合征	JUVENILE POLYPOSIS/HEREDITARY HEMORRHAGIC TELANGIECTASIA SYNDROME
STK11	Peutz-Jeghers综合征	PEUTZ-JEGHERS SYNDROME
STK11 	Peutz-Jeghers综合征	PEUTZ-JEGHERS SYNDROME
FLNB	骨发育不全症	ATELOSTEOGENESIS, TYPE III
SERPING1	遗传性血管性水肿	ANGIOEDEMA, HEREDITARY, TYPE I
HOXD13	短指症	BRACHYDACTYLY, TYPE D
HOXD13	短指症	BRACHYDACTYLY, TYPE E1
MYC	伯基特淋巴瘤	BURKITT LYMPHOMA
FGFR3	致死性颅骨发育不良	THANATOPHORIC DYSPLASIA, TYPE II
RNU4ATAC	小头骨发育不良先天性侏儒症	MICROCEPHALIC OSTEODYSPLASTIC PRIMORDIAL DWARFISM, TYPE I
RNU4ATAC 	小头骨发育不良先天性侏儒症	MICROCEPHALIC OSTEODYSPLASTIC PRIMORDIAL DWARFISM, TYPE I
MR1	阵发性非运动诱发性运动障碍	PAROXYSMAL NONKINESIGENIC DYSKINESIA 1
PAX6	眼部缺损	COLOBOMA, OCULAR, AUTOSOMAL DOMINANT
PAX6	视神经缺损	COLOBOMA OF OPTIC NERVE
AMACR	先天性胆汁酸合成缺陷	BILE ACID SYNTHESIS DEFECT, CONGENITAL, 4
SERPING1	补体成分缺乏症	COMPLEMENT COMPONENT 4, PARTIAL DEFICIENCY OF
RECQL4	巴-格二氏综合征:颅缝早闭-桡骨发育不全综合征	BALLER-GEROLD SYNDROME
MAPT	帕金森-痴呆综合征	PARKINSON-DEMENTIA SYNDROME
GH1	单一性生长素缺乏症	ISOLATED GROWTH HORMONE DEFICIENCY, TYPE IA
IMPDH1	莱伯氏先天性黑矇	LEBER CONGENITAL AMAUROSIS 11
ELN	皮肤松弛症	CUTIS LAXA, AUTOSOMAL DOMINANT 1
ITPA	肌苷三磷酸酶缺乏	INOSINE TRIPHOSPHATASE DEFICIENCY
DSPP	牙本质发育不良	DENTINOGENESIS IMPERFECTA, SHIELDS TYPE III
TOR1A	肌张力障碍	DYSTONIA 1, TORSION, AUTOSOMAL DOMINANT
RECQL4	先天性皮肤异色症	ROTHMUND-THOMSON SYNDROME
EDAR	外胚层发育不良	ECTODERMAL DYSPLASIA 10A, HYPOHIDROTIC/HAIR/NAIL TYPE, AUTOSOMAL DOMINANT
CFC1	右向襻转型小儿大动脉错位	TRANSPOSITION OF THE GREAT ARTERIES, DEXTRO-LOOPED 2
GDF1 	右向襻转型小儿大动脉错位	TRANSPOSITION OF THE GREAT ARTERIES, DEXTRO-LOOPED 3
CACNB4 	周期性共济失调	EPISODIC ATAXIA, TYPE 5
FCN3 	免疫缺陷	IMMUNODEFICIENCY DUE TO FICOLIN 3 DEFICIENCY
RBM8A	染色体缺失综合征	THROMBOCYTOPENIA-ABSENT RADIUS SYNDROME
HEPACAM 	巨颅伴皮层下海绵样囊肿性脑白质病	MEGALENCEPHALIC LEUKOENCEPHALOPATHY WITH SUBCORTICAL CYSTS 2A
COL7A1	大疱性表皮松解症	EPIDERMOLYSIS BULLOSA DYSTROPHICA, PRETIBIAL
HEPACAM	巨颅伴皮层下海绵样囊肿性脑白质病	MEGALENCEPHALIC LEUKOENCEPHALOPATHY WITH SUBCORTICAL CYSTS 2B, REMITTING,
PLEC1	单纯型大疱性表皮松解症	EPIDERMOLYSIS BULLOSA SIMPLEX, OGNA TYPE
KRT5	单纯型大疱性表皮松解症	EPIDERMOLYSIS BULLOSA SIMPLEX WITH MOTTLED PIGMENTATION
CD4	OKT4抗原决定基缺陷	OKT4 EPITOPE DEFICIENCY
RPGR	黄斑变性	MACULAR DEGENERATION, X-LINKED ATROPHIC
FLCN	Birt-Hogg-Dube综合征	BIRT-HOGG-DUBE SYNDROME
XK	McLeod综合征	MCLEOD SYNDROME
SLC36A2	亚氨基甘氨酸尿症	HYPERGLYCINURIA
KRT74 	单一性头皮稀毛症	HYPOTRICHOSIS 3
NHP2	先天性角化不良	DYSKERATOSIS CONGENITA, AUTOSOMAL RECESSIVE, 2
HNF1A	家族性肝腺瘤	HEPATIC ADENOMAS, FAMILIAL
WRAP53 	先天性角化不良	DYSKERATOSIS CONGENITA, AUTOSOMAL RECESSIVE, 3
CDC73	甲状旁腺功能亢进	HYPERPARATHYROIDISM 1
TMEM70	线粒体复合物缺乏症	MITOCHONDRIAL COMPLEX V (ATP SYNTHASE) DEFICIENCY, NUCLEAR TYPE 2
MTATP6	婴儿线粒体纹状体黑质变性症	STRIATONIGRAL DEGENERATION, INFANTILE, MITOCHONDRIAL
MTTI	线粒体相关的低镁血症,高血压和高胆固醇血症	HYPOMAGNESEMIA, HYPERTENSION, AND HYPERCHOLESTEROLEMIA, MITOCHONDRIAL
MTTL1	周期性呕吐综合征	CYCLIC VOMITING SYNDROME
MTTE	线粒体肌病	MITOCHONDRIAL MYOPATHY, INFANTILE, DUE TO REVERSIBLE CYTOCHROME C
ND4L	腹泻	DIARRHEA, CHRONIC, WITH VILLOUS ATROPHY
IGKC 	免疫球蛋白κ轻链缺乏	IMMUNOGLOBULIN KAPPA LIGHT CHAIN DEFICIENCY
CDC73	甲状旁腺功能亢进	HYPERPARATHYROIDISM 2
non-coding	慢性肾小管间质性肾病	NEPHROPATHY, CHRONIC TUBULOINTERSTITIAL
MTATP6	神经病,共济失调及色素性视网膜炎	NEUROPATHY, ATAXIA, AND RETINITIS PIGMENTOSA
THRB	甲状腺激素抵抗综合征	THYROID HORMONE RESISTANCE, SELECTIVE PITUITARY
DYRK1A	智力低下	MENTAL RETARDATION, AUTOSOMAL DOMINANT 7
ALPL	低磷酸酯酶症	HYPOPHOSPHATASIA, ADULT
PROM1	黄色斑点状眼底	STARGARDT DISEASE 4
ZNF644	近视	MYOPIA 21, AUTOSOMAL DOMINANT
JPH3	亨廷顿病	HUNTINGTON DISEASE-LIKE 2
HR	少毛症	HYPOTRICHOSIS 4
TECT1 	朱伯特综合征	JOUBERT SYNDROME 13
PDE8B	原发性色素性结节状肾上腺皮质病	PIGMENTED NODULAR ADRENOCORTICAL DISEASE, PRIMARY, 3
ATXN8	脊髓小脑性共济失调	SPINOCEREBELLAR ATAXIA 8
C9orf72	额颞痴呆	FRONTOTEMPORAL DEMENTIA AND/OR AMYOTROPHIC LATERAL SCLEROSIS 1
COL2A1	异型增生	CZECH DYSPLASIA
MTAP	骨干延髓狭窄伴恶性纤维组织细胞瘤	DIAPHYSEAL MEDULLARY STENOSIS WITH MALIGNANT FIBROUS HISTIOCYTOMA
INSR	高胰岛素低血糖症	HYPERINSULINEMIC HYPOGLYCEMIA, FAMILIAL, 5
DOLK	先天性糖基化障碍	CONGENITAL DISORDER OF GLYCOSYLATION, TYPE Im
SMARCAD1	皮纹病	ADERMATOGLYPHIA
HINT1 	神经性肌强直和轴索型神经病	NEUROMYOTONIA AND AXONAL NEUROPATHY, AUTOSOMAL RECESSIVE
BFSP1	白内障	CATARACT 33
CITED2	室间隔缺损	VENTRICULAR SEPTAL DEFECT 2
TNNI3	扩张型心肌病	CARDIOMYOPATHY, DILATED, 2A
CITED2 	房间隔缺损	ATRIAL SEPTAL DEFECT 8
SCG5	息肉综合征	POLYPOSIS SYNDROME, HEREDITARY MIXED, 1
MBL2	甘露糖结合蛋白缺乏	MANNOSE-BINDING PROTEIN DEFICIENCY
FBLN5	皮肤松弛症	CUTIS LAXA, AUTOSOMAL DOMINANT 2
MS4A1	常见变异型免疫缺陷病	IMMUNODEFICIENCY, COMMON VARIABLE, 5
NKX2-5	左心发育不良综合征	HYPOPLASTIC LEFT HEART SYNDROME 2
EFEMP2 	腓骨肌萎缩症	CUTIS LAXA, AUTOSOMAL RECESSIVE, TYPE IB
MIR184	EDICT综合征	EDICT SYNDROME
COG5	先天性糖基化障碍	CONGENITAL DISORDER OF GLYCOSYLATION, TYPE IIi
MPL	特发性血小板增多症	THROMBOCYTHEMIA 2
SDHA	扩张型心肌病	CARDIOMYOPATHY, DILATED, 1GG
BRAF	豹皮综合征	LEOPARD SYNDROME 3
FGFR2	弯骨发育不良综合征	BENT BONE DYSPLASIA SYNDROME
NMNAT1	莱伯氏先天性黑矇	LEBER CONGENITAL AMAUROSIS 9
KDM6A	Kabuki综合征	KABUKI SYNDROME 2
PYCR1	皮肤松弛症	CUTIS LAXA, AUTOSOMAL RECESSIVE, TYPE IIIB
THBD	血栓	THROMBOPHILIA DUE TO THROMBOMODULIN DEFECT
PLCG2	家族性寒冷性荨麻疹	FAMILIAL COLD AUTOINFLAMMATORY SYNDROME 3
TMLHE	自闭症	EPSILON-TRIMETHYLLYSINE HYDROXYLASE DEFICIENCY
PROS1	易栓症	THROMBOPHILIA DUE TO PROTEIN S DEFICIENCY, AUTOSOMAL RECESSIVE
GATA6	房间隔缺损	ATRIAL SEPTAL DEFECT 9
HTR1A 	月经周期依赖型周期性发热	PERIODIC FEVER, MENSTRUAL CYCLE-DEPENDENT
MYF6	中央核性肌病	MYOPATHY, CENTRONUCLEAR, 3
AGK	白内障	CATARACT 38
GRN	神经元蜡样质脂褐质沉积症	CEROID LIPOFUSCINOSIS, NEURONAL, 11
COL18A1	Knobloch综合征	KNOBLOCH SYNDROME 1
KIF1A 	感觉自主神经病	NEUROPATHY, HEREDITARY SENSORY, TYPE IIC
SF3B1	骨髓增生异常综合征	MYELODYSPLASTIC SYNDROME
HARS	尤塞氏综合症	USHER SYNDROME, TYPE IIIB
LTBP4	皮肤松垂伴严重肺、胃肠及泌尿系统异常	CUTIS LAXA, AUTOSOMAL RECESSIVE, TYPE IC
LTBP5	皮肤松垂伴严重肺、胃肠及泌尿系统异常	CUTIS LAXA, AUTOSOMAL RECESSIVE, TYPE IC
LTBP6	皮肤松垂伴严重肺、胃肠及泌尿系统异常	CUTIS LAXA, AUTOSOMAL RECESSIVE, TYPE IC
LTBP7	皮肤松垂伴严重肺、胃肠及泌尿系统异常	CUTIS LAXA, AUTOSOMAL RECESSIVE, TYPE IC
LTBP8	皮肤松垂伴严重肺、胃肠及泌尿系统异常	CUTIS LAXA, AUTOSOMAL RECESSIVE, TYPE IC
ATOH7	持久性原发性玻璃体增生症	PERSISTENT HYPERPLASTIC PRIMARY VITREOUS, AUTOSOMAL RECESSIVE
PDSS1	辅酶Q10缺陷症	COENZYME Q10 DEFICIENCY, PRIMARY, 2
PDSS2 	辅酶Q10缺陷症	COENZYME Q10 DEFICIENCY, PRIMARY, 3
HSD11B1	氧化还原酶缺乏症	CORTISONE REDUCTASE DEFICIENCY 2
PIK3CA	先天性脂肪瘤过度生长,血管畸形和表皮痣	CONGENITAL LIPOMATOUS OVERGROWTH, VASCULAR MALFORMATIONS, AND EPIDERMAL
ABCC9 	Cantu综合征	CANTU SYNDROME
DNAAF3	原发性纤毛运动障碍	CILIARY DYSKINESIA, PRIMARY, 2
WDR81	小脑性共济失调,智力低下和平衡失调综合征	CEREBELLAR ATAXIA, MENTAL RETARDATION, AND DYSEQUILIBRIUM SYNDROME
SNIP1	精神运动性迟滞,癫痫和颅颌面异形	PSYCHOMOTOR RETARDATION, EPILEPSY, AND CRANIOFACIAL DYSMORPHISM
ABCD4	甲基丙二酸尿症	METHYLMALONIC ACIDURIA AND HOMOCYSTINURIA, cblJ TYPE
GNAI3	耳—髁状突综合征	AURICULOCONDYLAR SYNDROME 1
TSC2	结节性硬化症	TUBEROUS SCLEROSIS 2
CORIN	先兆子痫/子痫惊厥	PREECLAMPSIA/ECLAMPSIA 5
NIN	Seckel综合征	SECKEL SYNDROME 7
MIR17HG	FEINGOLD综合征	FEINGOLD SYNDROME 2
AKT2	低胰岛素血症型低血糖伴偏身肥大	HYPOINSULINEMIC HYPOGLYCEMIA WITH HEMIHYPERTROPHY
CPA6	热性惊厥	FEBRILE SEIZURES, FAMILIAL, 11
NBAS 	身材矮小症	SHORT STATURE, OPTIC NERVE ATROPHY, AND PELGER-HUET ANOMALY
PLAU	魁北克血小板异常	QUEBEC PLATELET DISORDER
CCDC78 	中央核性肌病	MYOPATHY, CENTRONUCLEAR, 4
GRK1	先天性夜盲症	OGUCHI DISEASE 2
SAMHD1 	冻疮样狼疮	CHILBLAIN LUPUS 2
CAMTA1 	小脑性共济失调	CEREBELLAR ATAXIA, NONPROGRESSIVE, WITH MENTAL RETARDATION
MIR96	先天性耳聋	DEAFNESS, AUTOSOMAL DOMINANT 50
TUBGCP6	小头畸形	MICROCEPHALY AND CHORIORETINOPATHY, AUTOSOMAL RECESSIVE, 1
UVSSA	紫外线敏感综合征	UV-SENSITIVE SYNDROME 3
TCTN3 	朱伯特综合征	JOUBERT SYNDROME 18
ERCC8	紫外线敏感综合征	UV-SENSITIVE SYNDROME 2
SCN8A 	小脑性共济失调	COGNITIVE IMPAIRMENT WITH OR WITHOUT CEREBELLAR ATAXIA
DST	感觉自主神经病	NEUROPATHY, HEREDITARY SENSORY AND AUTONOMIC, TYPE VI
12-Sep	生精障碍	SPERMATOGENIC FAILURE 10
RTTN	多小脑回畸形	POLYMICROGYRIA WITH SEIZURES
PMS2	大肠癌	COLORECTAL CANCER, HEREDITARY NONPOLYPOSIS, TYPE 4
C4orf26	牙釉质发育不全	AMELOGENESIS IMPERFECTA, HYPOMATURATION TYPE, IIA4
GRM1	脊髓小脑性共济失调	SPINOCEREBELLAR ATAXIA, AUTOSOMAL RECESSIVE 13
CRADD	智力低下	MENTAL RETARDATION, AUTOSOMAL RECESSIVE 34
TGFBR2 	大肠癌	COLORECTAL CANCER, HEREDITARY NONPOLYPOSIS, TYPE 6
ARID1B	智力低下	MENTAL RETARDATION, AUTOSOMAL DOMINANT 12
SMARCA4	智力低下	MENTAL RETARDATION, AUTOSOMAL DOMINANT 16
OPLAH	水解酶缺乏症	5-@OXOPROLINASE DEFICIENCY
ARID1A	智力低下	MENTAL RETARDATION, AUTOSOMAL DOMINANT 14
GTDC2	肌营养不良-抗肌萎缩相关糖蛋白病	MUSCULAR DYSTROPHY-DYSTROGLYCANOPATHY (CONGENITAL WITH BRAIN AND EYE
NPHP1	senior-loken综合征	SENIOR-LOKEN SYNDROME 1
LMBR1	并指	SYNDACTYLY, TYPE IV
NHS,SCML1,RAI2	白内障	CATARACT 40
NHS	白内障	CATARACT 40
LMBR1	无手足畸形	ACHEIROPODY
MT-COI	反复性肌红蛋白尿	MYOGLOBINURIA, RECURRENT
DOCK8	智力低下	MENTAL RETARDATION, AUTOSOMAL DOMINANT 2
CHD7	染色体8q12.1-q21.2缺失综合征	CHROMOSOME 8q12.1-q21.2 DELETION SYNDROME
SNAI2	瓦登伯革氏症候群	WAARDENBURG SYNDROME, TYPE 2D
AR	脊髓延髓肌肉萎缩症	SPINAL AND BULBAR MUSCULAR ATROPHY, X-LINKED 1
TAF1	肌张力障碍	DYSTONIA 3, TORSION, X-LINKED
GNAS,GNAS-AS1	假性甲状旁腺功能减退症	PSEUDOHYPOPARATHYROIDISM, TYPE IB
STX16	假性甲状旁腺功能减退症	PSEUDOHYPOPARATHYROIDISM, TYPE IB
KANK1	痉挛性四肢瘫痪,脑性麻痹	CEREBRAL PALSY, SPASTIC QUADRIPLEGIC, 2
C50orf42,SLC1A3,NUP155,WDR70,NIPBL	染色体5p13重复综合征	CHROMOSOME 5p13 DUPLICATION SYNDROME
PAFAH1B1,YWHAE,CRK	染色体17p13.3，着丝粒，重复综合征	CHROMOSOME 17p13.3, CENTROMERIC, DUPLICATION SYNDROME
TJP2,FAM189A2	先天性耳聋	DEAFNESS, AUTOSOMAL DOMINANT 51
NF1	染色体17q11.2缺失综合征，1.4 MB	CHROMOSOME 17q11.2 DELETION SYNDROME, 1.4-MB
ATXN3	脊髓小脑性共济失调	MACHADO-JOSEPH DISEASE
BEAN1	脊髓小脑性共济失调	SPINOCEREBELLAR ATAXIA 31
ATN1	齿状核-红核-苍白球-丘脑底核萎缩症	DENTATORUBRAL-PALLIDOLUYSIAN ATROPHY
PMP22	格-巴二氏综合征	GUILLAIN-BARRE SYNDROME, FAMILIAL
FDFT1	染色体重复综合征	RECOMBINANT CHROMOSOME 8 SYNDROME
SLCO5A1,SULF1	MESOMELIA-骨性联接综合征	MESOMELIA-SYNOSTOSES SYNDROME
DVL1,GABRD,GNB1,PRKCZ,SKI	染色体1p36缺失综合征	CHROMOSOME 1p36 DELETION SYNDROME
HOXD1,SATB2,COL3A1,COL5A2,GTF3C3,CASP8,CASP10	玻璃综合征	GLASS SYNDROME
BPNT1,PSEN2	染色体1q41-Q42缺失综合征	CHROMOSOME 1q41-q42 DELETION SYNDROME
FOXC1	染色体6pter-P24缺失综合征	CHROMOSOME 6pter-p24 DELETION SYNDROME
IGF1R	染色体15q26-qter缺失综合征	CHROMOSOME 15q26-qter DELETION SYNDROME
TBX2,TBX4	染色体17q23.1-q23.2缺失综合征	CHROMOSOME 17q23.1-q23.2 DELETION SYNDROME
SH2B1	染色体16p11.2缺失综合征	CHROMOSOME 16p11.2 DELETION SYNDROME, 220-KB
HIP1,MAGI2,YWHAG	染色体7q11.23缺失综合征	CHROMOSOME 7q11.23 DELETION SYNDROME, DISTAL, 1.2-MB
NFIA	染色体1p32-P31缺失综合征	CHROMOSOME 1p32-p31 DELETION SYNDROME
CTNND2	累若纳(氏)综合征,猫叫综合征	CRI-DU-CHAT SYNDROME
MAP2K6	多毛症	HYPERTRICHOSIS, CONGENITAL GENERALIZED, WITH OR WITHOUT GINGIVAL HYPERPLASIA
SOX8	α地中海贫血/智力低下综合征	ALPHA-THALASSEMIA/MENTAL RETARDATION SYNDROME, CHROMOSOME 16-RELATED
PTPN14	后鼻孔闭锁及淋巴水肿	CHOANAL ATRESIA AND LYMPHEDEMA
TRPS1,EXT1	毛发-鼻-指(趾)综合征	TRICHORHINOPHALANGEAL SYNDROME, TYPE II
RPS14	染色体缺失综合征	CHROMOSOME 5q DELETION SYNDROME
DMRT	46,性反转	46,XY SEX REVERSAL 4
MBD5	智力低下	MENTAL RETARDATION, AUTOSOMAL DOMINANT 1
TYRP1	染色体9p缺失综合征	CHROMOSOME 9p DELETION SYNDROME
FGF3	OTODENTAL发育不良	OTODENTAL DYSPLASIA
LMNB1	脑白质营养不良	LEUKODYSTROPHY, DEMYELINATING, ADULT-ONSET, AUTOSOMAL DOMINANT
LMBR1	轴前多指畸形	POLYDACTYLY, PREAXIAL II
SNRPN,NDN	Prader-Willi综合征(肥胖综合征)	PRADER-WILLI SYNDROME
ELN,LIMK1	WILLIAMS-BEUREN综合征	WILLIAMS-BEUREN SYNDROME
PAX6,WT1	肾母细胞瘤	WILMS TUMOR, ANIRIDIA, GENITOURINARY ANOMALIES, AND MENTAL RETARDATION
LBX1,BTRC,POLL	SPLIT-手/脚畸形的3	SPLIT-HAND/FOOT MALFORMATION 3
PRP8,RILP,SREC,PITPNA,SKIP,MYO1C,CRK,YWHAE	MILLER-DIEKER无脑回畸形综合征	MILLER-DIEKER LISSENCEPHALY SYNDROME
WNK1	假性醛固酮过少症	PSEUDOHYPOALDOSTERONISM, TYPE IIC
NR0B1	46,性反转	46,XY SEX REVERSAL 2
COL4A5,FACL4,NXT2,KCNE5,GUCY2F	Alport综合征	AMME COMPLEX
ABCD1,BCAP31	耳聋，肌张力障碍和脑低髓鞘化	DEAFNESS, DYSTONIA, AND CEREBRAL HYPOMYELINATION
RP2,SLC9A7,ZNF673,CHST7,MIRN221,MIRN222	染色体Xp11.3缺失综合征	CHROMOSOME Xp11.3 DELETION SYNDROME
GK,DMD	Chromosome Xp21缺失综合征	CHROMOSOME Xp21 DELETION SYNDROME
SYP	染色体Xp11.23-p11.22重复综合征	CHROMOSOME Xp11.23-p11.22 DUPLICATION SYNDROME
GDI1	染色体Xq28重复综合征	CHROMOSOME Xq28 DUPLICATION SYNDROME
SOX3	46,性反转	46,XX SEX REVERSAL 3
BRCC3,MTCP1NB	烟雾病	MOYAMOYA DISEASE 4 WITH SHORT STATURE, HYPERGONADOTROPIC HYPOGONADISM,
COL4A5,COL4A6	弥漫性平滑肌瘤病伴Alport综合征	LEIOMYOMATOSIS, DIFFUSE, WITH ALPORT SYNDROME
EXT2,ALX4	POTOCKI-SHAFFER综合征	POTOCKI-SHAFFER SYNDROME
TSHZ1	染色体18q的缺失综合征	CHROMOSOME 18q DELETION SYNDROME
SNCA	遗传性帕金森病	PARKINSON DISEASE 4, AUTOSOMAL DOMINANT
SLC3A1,PPM1B,PREPL,C2ORF34	肌张力低下-胱氨酸尿症综合征	HYPOTONIA-CYSTINURIA SYNDROME
USH1C,ABCC8,KCNJ11	纯合11p15-P14缺失综合征	HOMOZYGOUS 11p15-p14 DELETION SYNDROME
FBLN1-D	并指(趾)多指(趾)	SYNPOLYDACTYLY 2
GABRA5,GABRG3	染色体15q11-Q13重复综合征	CHROMOSOME 15q11-q13 DUPLICATION SYNDROME
DAGLA/SCA20	脊髓小脑性共济失调	SPINOCEREBELLAR ATAXIA 20
FBXO45,DLG1,PAK2	染色体3q29缺失综合征	CHROMOSOME 3q29 DELETION SYNDROME
NPHP1	朱伯特综合征	JOUBERT SYNDROME 4
DOCK1,C10ORF90	染色体10q26缺失综合征	CHROMOSOME 10q26 DELETION SYNDROME
Gtf2i	williams-beuren区域重复综合征	WILLIAMS-BEUREN REGION DUPLICATION SYNDROME
CREBBP,DNASE1	染色体16p13.3缺失综合征	CHROMOSOME 16p13.3 DELETION SYNDROME, PROXIMAL
STRADA	羊水过多伴巨脑,症状性癫痫	POLYHYDRAMNIOS, MEGALENCEPHALY, AND SYMPTOMATIC EPILEPSY
MRT6	智力低下	MENTAL RETARDATION, AUTOSOMAL RECESSIVE 6
KIAA0377,CKMT1B,STRC,CATSPER2	耳聋，感音性，与男性不育	DEAFNESS-INFERTILITY SYNDROME
KCTD13	染色体16p11.2缺失综合征	CHROMOSOME 16p11.2 DELETION SYNDROME, 593-KB
CHRNA7	染色体15q13.3缺失综合征	CHROMOSOME 15q13.3 DELETION SYNDROME
ZNF238,FAM36A,C1ORF199,HNRNPU	智力低下	MENTAL RETARDATION, AUTOSOMAL DOMINANT 22
ZNF385B	染色体2q31.2缺失综合征	CHROMOSOME 2q31.2 DELETION SYNDROME
GJB6	先天性耳聋	DEAFNESS, AUTOSOMAL RECESSIVE 1B
PLCB1	癫痫	EPILEPTIC ENCEPHALOPATHY, EARLY INFANTILE, 12
KCNAB3,GUCY2D	染色体17p13.1缺失综合征	CHROMOSOME 17p13.1 DELETION SYNDROME
CNTN4,ITPR1,SRGAP3	染色体3pter-P25缺失综合征	CHROMOSOME 3pter-p25 DELETION SYNDROME
NUFIP1,HTR2A,PCDH8,PCDH17	染色体13q14缺失综合征	CHROMOSOME 13q14 DELETION SYNDROME
C16orf54,ZG16,MVP	染色体16p11.2重复综合征	CHROMOSOME 16p11.2 DUPLICATION SYNDROME
CCL3L1,ZNHIT3,DHRS11,LHX1,ACACA,TADA2A	染色体17q12重复综合征	CHROMOSOME 17q12 DUPLICATION SYNDROME
CBFB,RRAD,HSF4,ZFHX3	染色体16q22缺失综合征	CHROMOSOME 16q22 DELETION SYNDROME
TCF2,ZNHIT3,LHX1,HNF1B,C17orf102	染色体17q12缺失综合征	CHROMOSOME 17q12 DELETION SYNDROME
IREB2,FAH,AKAP13,MRPL46	染色体15q25缺失综合征	CHROMOSOME 15q25 DELETION SYNDROME
ZFHX4-AS1,ZFHX4,PEX2	染色体8q21.11缺失综合征	CHROMOSOME 8q21.11 DELETION SYNDROME
ABHD2,IDH2,LOC400456,LRRK1,TM2D3	Levy-Shanske综合征	TETRASOMY 15q26
CHM,POU3F4	无脉络膜，耳聋和智力迟钝	CHOROIDEREMIA, DEAFNESS, AND MENTAL RETARDATION
FMR1,AFF2,IDS,MTM1	染色体Xq27.3-Q28重复综合征	CHROMOSOME Xq27.3-q28 DUPLICATION SYNDROME
TYMS,METTL4,LAMA1,RNMT	Tetrasomy 18p	TETRASOMY 18p
NLGN3	自闭症	AUTISM, SUSCEPTIBILITY TO, X-LINKED 1
NLGN4X	自闭症	AUTISM, SUSCEPTIBILITY TO, X-LINKED 2
SLC9A9	自闭症	AUTISM, SUSCEPTIBILITY TO, 16
SHANK2	自闭症	AUTISM, SUSCEPTIBILITY TO, 17
CHD8	自闭症	AUTISM, SUSCEPTIBILITY TO, 18
EIF4E	自闭症	AUTISM, SUSCEPTIBILITY TO, 19
ACADL	氧化还原酶缺乏症	ACYL-CoA DEHYDROGENASE, VERY LONG-CHAIN, DEFICIENCY OF
ZFYVE27	遗传性痉挛性截瘫	SPASTIC PARAPLEGIA 33, AUTOSOMAL DOMINANT
MECP2	X连锁智力低下	LUBS X-LINKED MENTAL RETARDATION SYNDROME